AAAAAAAGAGG -> AAAAAAGAGGT
AAAAAAGAGGT -> AAAAAGAGGTT
AAAAAGAGGTT -> AAAAGAGGTTA
AAAAAGTCGAT -> AAAAGTCGATC
AAAACGTCGAC -> AAACGTCGACG
AAAAGAAACCC -> AAAGAAACCCT
AAAAGAGGTTA -> AAAGAGGTTAA
AAAAGCGCGGT -> AAAGCGCGGTT
AAAAGTCGATC -> AAAGTCGATCG
AAAAGTGCCCC -> AAAGTGCCCCA
AAAAGTGGATA -> AAAGTGGATAC
AAAATCGGCTG -> AAATCGGCTGA
AAAATGAGATG -> AAATGAGATGT
AAAATGATTCA -> AAATGATTCAA
AAACATATTCT -> AACATATTCTT
AAACCATCACT -> AACCATCACTT
AAACCCAGCAA -> AACCCAGCAAG
AAACCCCTAGG -> AACCCCTAGGT
AAACCCTAGGT -> AACCCTAGGTG
AAACCCTCCTA -> AACCCTCCTAA
AAACCGAACAG -> AACCGAACAGT
AAACCGGCCAC -> AACCGGCCACT
AAACGTCGACG -> AACGTCGACGT
AAACTCCGGGG -> AACTCCGGGGA
AAACTCTCTAC -> AACTCTCTACT
AAACTCTTCAT -> AACTCTTCATG
AAACTGTACAC -> AACTGTACACC
AAAGAAACCCT -> AAGAAACCCTC
AAAGAAGTTTG -> AAGAAGTTTGG
AAAGAGAGGGT -> AAGAGAGGGTA
AAAGAGGTTAA -> AAGAGGTTAAC
AAAGAGTCCGT -> AAGAGTCCGTT
AAAGCCCGCGT -> AAGCCCGCGTG
AAAGCGCGGTT -> AAGCGCGGTTA
AAAGGCGCCTT -> AAGGCGCCTTG
AAAGTCGATCG -> AAGTCGATCGT
AAAGTGCCCCA -> AAGTGCCCCAC
AAAGTGGATAC -> AAGTGGATACG
AAATAGTCCTT -> AATAGTCCTTA
AAATCGGCTGA -> AATCGGCTGAT
AAATCGGTAAA -> AATCGGTAAAA
AAATGAGATGT -> AATGAGATGTA
AAATGATTCAA -> AATGATTCAAT
AAATTATAACA -> AATTATAACAT
AACACTACAAC -> ACACTACAACT
AACAGAAACTC -> ACAGAAACTCT
AACAGGATGCG -> ACAGGATGCGG
AACAGTGTCAC -> ACAGTGTCACA
AACATATTCTT -> ACATATTCTTG
AACATCCCTGT -> ACATCCCTGTG
AACATGGTCCC -> ACATGGTCCCC
AACCATCACTT -> ACCATCACTTG
AACCATTGTGA -> ACCATTGTGAG
AACCCAGCAAG -> ACCCAGCAAGG
AACCCCTAGGT -> ACCCCTAGGTT
AACCCTAGGTG -> ACCCTAGGTGG
AACCCTCCTAA -> ACCCTCCTAAA
AACCGAACAGT -> ACCGAACAGTG
AACCGCCTCGC -> ACCGCCTCGCG
AACCGGCCACT -> ACCGGCCACTC
AACCTTAGGGA -> ACCTTAGGGAT
AACGAGGTACG -> ACGAGGTACGG
AACGATAAGCA -> ACGATAAGCAG
AACGATCTATG -> ACGATCTATGA
AACGATTGAGC -> ACGATTGAGCA
AACGCGTCCCG -> ACGCGTCCCGT
AACGGTATTTT -> ACGGTATTTTC
AACGTCGACGT -> ACGTCGACGTG
AACTCCGGGGA -> ACTCCGGGGAC
AACTCTCTACT -> ACTCTCTACTG
AACTCTTCATG -> ACTCTTCATGG
AACTGAAACAT -> ACTGAAACATA
AACTGATCTTT -> ACTGATCTTTA
AACTGTACACC -> ACTGTACACCT
AACTGTGCATA -> ACTGTGCATAA
AACTTCACTAG -> ACTTCACTAGT
AACTTTGCTAA -> ACTTTGCTAAA
AACTTTGGATA -> ACTTTGGATAT
AAGAAAATGAG -> AGAAAATGAGA
AAGAAACCCTC -> AGAAACCCTCC
AAGAAGTTTGG -> AGAAGTTTGGG
AAGAATCGTTG -> AGAATCGTTGC
AAGAGAGGGTA -> AGAGAGGGTAG
AAGAGGCTATA -> AGAGGCTATAT
AAGAGGTTAAC -> AGAGGTTAACG
AAGAGTCCGTT -> AGAGTCCGTTA
AAGCAACAGGA -> AGCAACAGGAT
AAGCAGGCCGA -> AGCAGGCCGAG
AAGCAGTAAAG -> AGCAGTAAAGG
AAGCATGCGGA -> AGCATGCGGAT
AAGCCCCCTCA -> AGCCCCCTCAT
AAGCCCGCGTG -> AGCCCGCGTGC
AAGCCCTAATG -> AGCCCTAATGT
AAGCGATGGCT -> AGCGATGGCTG
AAGCGCGCACC -> AGCGCGCACCG
AAGCGCGGTTA -> AGCGCGGTTAA
AAGCGGGGTGG -> AGCGGGGTGGC
AAGCTTTGAGC -> AGCTTTGAGCT
AAGGAAACTCC -> AGGAAACTCCG
AAGGAGGGAGA -> AGGAGGGAGAA
AAGGATGGAGG -> AGGATGGAGGG
AAGGCCGTCAG -> AGGCCGTCAGT
AAGGCGCCTTG -> AGGCGCCTTGC
AAGGCGTGCGT -> AGGCGTGCGTG
AAGGTCGTTTC -> AGGTCGTTTCC
AAGTAGTTTCC -> AGTAGTTTCCT
AAGTCGATCGT -> AGTCGATCGTT
AAGTGACCGAT -> AGTGACCGATG
AAGTGCCCCAC -> AGTGCCCCACA
AAGTGGATACG -> AGTGGATACGA
AAGTGGGCTTT -> AGTGGGCTTTC
AAGTTAACTTT -> AGTTAACTTTG
AAGTTTGGGAC -> AGTTTGGGACA
AATACATCACC -> ATACATCACCC
AATACTCCTGT -> ATACTCCTGTT
AATACTGCGGG -> ATACTGCGGGT
AATAGGGACGC -> ATAGGGACGCC
AATAGTCCTTA -> ATAGTCCTTAT
AATATGATGAT -> ATATGATGATC
AATCCATGTGA -> ATCCATGTGAA
AATCCGTGGTA -> ATCCGTGGTAC
AATCGAGTCTC -> ATCGAGTCTCC
AATCGGCTGAT -> ATCGGCTGATT
AATCGGTAAAA -> ATCGGTAAAAG
AATCGTTGCTT -> ATCGTTGCTTC
AATCTTACGTG -> ATCTTACGTGA
AATGAGATGTA -> ATGAGATGTAC
AATGATTCAAT -> ATGATTCAATA
AATGCAAGTTA -> ATGCAAGTTAA
AATGCGCAGCG -> ATGCGCAGCGT
AATGGATATTT -> ATGGATATTTC
AATGTGAATAT -> ATGTGAATATG
AATTAGACAGA -> ATTAGACAGAT
AATTATAACAT -> ATTATAACATC
AATTCAAACCG -> ATTCAAACCGA
AATTCCATTGA -> ATTCCATTGAC
AATTCGCTGAA -> ATTCGCTGAAG
AATTTAGTGGA -> ATTTAGTGGAG
ACAAAACGTCG -> CAAAACGTCGA
ACAAAATGATT -> CAAAATGATTC
ACAAACCCCTA -> CAAACCCCTAG
ACAACAGAAAC -> CAACAGAAACT
ACAACCTTAGG -> CAACCTTAGGG
ACAACGATCTA -> CAACGATCTAT
ACAACTGTGCA -> CAACTGTGCAT
ACAAGCGGGGT -> CAAGCGGGGTG
ACAAGGTCGTT -> CAAGGTCGTTT
ACAATCGAGTC -> CAATCGAGTCT
ACACAAAACGT -> CACAAAACGTC
ACACCATTTAG -> CACCATTTAGA
ACACCGAGGTT -> CACCGAGGTTT
ACACCTAAACC -> CACCTAAACCA
ACACTACAACT -> CACTACAACTG
ACACTTTTAGT -> CACTTTTAGTC
ACAGAAAAGTG -> CAGAAAAGTGG
ACAGAAACTCT -> CAGAAACTCTC
ACAGAGCTATC -> CAGAGCTATCC
ACAGATGGCCC -> CAGATGGCCCG
ACAGATTCTGC -> CAGATTCTGCG
ACAGGAGAGCT -> CAGGAGAGCTT
ACAGGATGCGG -> CAGGATGCGGT
ACAGTGTCACA -> CAGTGTCACAG
ACATACGAATC -> CATACGAATCT
ACATATGGTAA -> CATATGGTAAA
ACATATTCTTG -> CATATTCTTGC
ACATCACCCTT -> CATCACCCTTG
ACATCCCTGTG -> CATCCCTGTGA
ACATCGCACTC -> CATCGCACTCG
ACATCTCTATG -> CATCTCTATGC
ACATGATAAAC -> CATGATAAACC
ACATGGCGTGT -> CATGGCGTGTA
ACATGGTCCCC -> CATGGTCCCCG
ACCAAACTGTA -> CCAAACTGTAC
ACCAAGCAGTA -> CCAAGCAGTAA
ACCAGAGTTAT -> CCAGAGTTATC
ACCAGGGACTT -> CCAGGGACTTA
ACCATCACTTG -> CCATCACTTGG
ACCATTGTGAG -> CCATTGTGAGC
ACCATTTAGAT -> CCATTTAGATT
ACCCAGCAAGG -> CCCAGCAAGGA
ACCCCTAGGTT -> CCCCTAGGTTG
ACCCCTCAGCC -> CCCCTCAGCCT
ACCCGATCGGT -> CCCGATCGGTA
ACCCGCGAGAC -> CCCGCGAGACA
ACCCTAAGAAT -> CCCTAAGAATC
ACCCTAGGTGG -> CCCTAGGTGGT
ACCCTCCTAAA -> CCCTCCTAAAG
ACCCTTGAACC -> CCCTTGAACCG
ACCCTTGTCAC -> CCCTTGTCACT
ACCGAACAGTG -> CCGAACAGTGT
ACCGACCGCCC -> CCGACCGCCCC
ACCGAGGTTTA -> CCGAGGTTTAA
ACCGAGTTGGA -> CCGAGTTGGAA
ACCGATGTGGT -> CCGATGTGGTA
ACCGCATAACG -> CCGCATAACGC
ACCGCCCCTCA -> CCGCCCCTCAC
ACCGCCTCGCG -> CCGCCTCGCGG
ACCGCGTCCAA -> CCGCGTCCAAG
ACCGGATGTTC -> CCGGATGTTCG
ACCGGCCACTC -> CCGGCCACTCG
ACCTAAACCAT -> CCTAAACCATC
ACCTACATGAT -> CCTACATGATA
ACCTATGTGAA -> CCTATGTGAAC
ACCTATTGACG -> CCTATTGACGT
ACCTTAGGGAT -> CCTTAGGGATA
ACCTTCCATGC -> CCTTCCATGCG
ACCTTGTCCAC -> CCTTGTCCACG
ACGAATCTTAC -> CGAATCTTACG
ACGACAGAAAA -> CGACAGAAAAG
ACGACCCCTCA -> CGACCCCTCAG
ACGACCCTTGT -> CGACCCTTGTC
ACGAGCGATAG -> CGAGCGATAGA
ACGAGGTACGG -> CGAGGTACGGC
ACGAGTACCGA -> CGAGTACCGAC
ACGAGTGAGCA -> CGAGTGAGCAG
ACGATAAGCAG -> CGATAAGCAGG
ACGATCTATGA -> CGATCTATGAT
ACGATTGAGCA -> CGATTGAGCAC
ACGCCTACACT -> CGCCTACACTT
ACGCGTCCCGT -> CGCGTCCCGTC
ACGGACATGGC -> CGGACATGGCG
ACGGCGCTTGT -> CGGCGCTTGTA
ACGGCTTTGGT -> CGGCTTTGGTG
ACGGGTGGTAA -> CGGGTGGTAAG
ACGGTATTTTC -> CGGTATTTTCA
ACGTAAAAAGT -> CGTAAAAAGTC
ACGTCGACGTG -> CGTCGACGTGA
ACGTGAGATTA -> CGTGAGATTAC
ACGTGATGTAC -> CGTGATGTACT
ACGTGTGGTTT -> CGTGTGGTTTT
ACTACAACTGT -> CTACAACTGTG
ACTACGAGTGA -> CTACGAGTGAG
ACTAGTAATTC -> CTAGTAATTCC
ACTATTCACGA -> CTATTCACGAC
ACTCCGGGGAC -> CTCCGGGGACG
ACTCCTGTTAA -> CTCCTGTTAAC
ACTCGCCTCGC -> CTCGCCTCGCC
ACTCGTAAGAA -> CTCGTAAGAAA
ACTCTCTACTG -> CTCTCTACTGC
ACTCTTCATGG -> CTCTTCATGGT
ACTGAAACATA -> CTGAAACATAT
ACTGATCTTTA -> CTGATCTTTAA
ACTGATCTTTT -> CTGATCTTTTC
ACTGCATCATT -> CTGCATCATTA
ACTGCGGGTTG -> CTGCGGGTTGG
ACTGCGTGCGA -> CTGCGTGCGAG
ACTGGGCACGG -> CTGGGCACGGA
ACTGTACACCT -> CTGTACACCTA
ACTGTGCATAA -> CTGTGCATAAA
ACTGTTTTAGG -> CTGTTTTAGGA
ACTTAAACCCT -> CTTAAACCCTA
ACTTATCGTCG -> CTTATCGTCGG
ACTTCACTAGT -> CTTCACTAGTA
ACTTCCGATGC -> CTTCCGATGCG
ACTTCTGCTGG -> CTTCTGCTGGA
ACTTGGTCGAT -> CTTGGTCGATA
ACTTTGCTAAA -> CTTTGCTAAAG
ACTTTGGATAT -> CTTTGGATATT
ACTTTTAGTCG -> CTTTTAGTCGT
AGAAAAGTGGA -> GAAAAGTGGAT
AGAAAATGAGA -> GAAAATGAGAT
AGAAACCCTCC -> GAAACCCTCCT
AGAAACTCTCT -> GAAACTCTCTA
AGAACGGTATT -> GAACGGTATTT
AGAAGGCGTGC -> GAAGGCGTGCG
AGAAGTTTGGG -> GAAGTTTGGGA
AGAATCGTTGC -> GAATCGTTGCT
AGAATGCGCAG -> GAATGCGCAGC
AGAATTTAGTG -> GAATTTAGTGG
AGACAACCTTA -> GACAACCTTAG
AGACAAGGTCG -> GACAAGGTCGT
AGACAGATGGC -> GACAGATGGCC
AGACAGATTCT -> GACAGATTCTG
AGACATATGGT -> GACATATGGTA
AGACCAGAGTT -> GACCAGAGTTA
AGAGAGGGTAG -> GAGAGGGTAGA
AGAGCTATCCT -> GAGCTATCCTA
AGAGCTTCGAG -> GAGCTTCGAGA
AGAGGCTATAT -> GAGGCTATATC
AGAGGGTAGAA -> GAGGGTAGAAC
AGAGGTTAACG -> GAGGTTAACGA
AGAGTCCGTTA -> GAGTCCGTTAG
AGAGTTATCAC -> GAGTTATCACC
AGATATTCACT -> GATATTCACTG
AGATGGCCCGT -> GATGGCCCGTC
AGATGTACCTA -> GATGTACCTAT
AGATTACAACG -> GATTACAACGA
AGATTCTGCGC -> GATTCTGCGCT
AGATTCTTACA -> GATTCTTACAA
AGCAACAGGAT -> GCAACAGGATG
AGCAAGGAAAC -> GCAAGGAAACT
AGCACGTAAAA -> GCACGTAAAAA
AGCAGGCCGAG -> GCAGGCCGAGC
AGCAGTAAAGG -> GCAGTAAAGGC
AGCAGTATACC -> GCAGTATACCT
AGCAGTCACCC -> GCAGTCACCCG
AGCATGCGGAT -> GCATGCGGATG
AGCCCCCTCAT -> GCCCCCTCATG
AGCCCGCGTGC -> GCCCGCGTGCG
AGCCCTAATGT -> GCCCTAATGTG
AGCCGGTAGTC -> GCCGGTAGTCG
AGCCTGACATC -> GCCTGACATCG
AGCGAAAGCCC -> GCGAAAGCCCG
AGCGATAAGAG -> GCGATAAGAGG
AGCGATAGACA -> GCGATAGACAA
AGCGATGGCTG -> GCGATGGCTGC
AGCGCGCACCG -> GCGCGCACCGC
AGCGCGGTTAA -> GCGCGGTTAAG
AGCGGGGTGGC -> GCGGGGTGGCG
AGCGTGGGTCG -> GCGTGGGTCGT
AGCTAAATTAT -> GCTAAATTATA
AGCTAACTGAA -> GCTAACTGAAA
AGCTATCCTAA -> GCTATCCTAAT
AGCTCGCGACA -> GCTCGCGACAA
AGCTTCGAGAC -> GCTTCGAGACA
AGCTTTGAGCT -> GCTTTGAGCTA
AGGAAACTCCG -> GGAAACTCCGG
AGGAAGCCCCC -> GGAAGCCCCCT
AGGACAAAATG -> GGACAAAATGA
AGGACCAAACT -> GGACCAAACTG
AGGAGAGCTTC -> GGAGAGCTTCG
AGGAGGGAGAA -> GGAGGGAGAAG
AGGATGCGGTT -> GGATGCGGTTA
AGGATGGAGGG -> GGATGGAGGGA
AGGATTAGACA -> GGATTAGACAT
AGGCCGAGCCG -> GGCCGAGCCGG
AGGCCGTCAGT -> GGCCGTCAGTC
AGGCGCCTTGC -> GGCGCCTTGCA
AGGCGTGCGTG -> GGCGTGCGTGA
AGGCTATATCA -> GGCTATATCAC
AGGGACCCTAA -> GGGACCCTAAG
AGGGACGCCTA -> GGGACGCCTAC
AGGGACTTATC -> GGGACTTATCG
AGGGAGAAGGC -> GGGAGAAGGCG
AGGGATACGGC -> GGGATACGGCT
AGGGCGCACTG -> GGGCGCACTGT
AGGGGCGGTTC -> GGGGCGGTTCA
AGGGGTCCTCC -> GGGGTCCTCCA
AGGGTAGAACG -> GGGTAGAACGG
AGGTAAATAGT -> GGTAAATAGTC
AGGTACGGCGC -> GGTACGGCGCT
AGGTCGTTTCC -> GGTCGTTTCCC
AGGTGGTAACA -> GGTGGTAACAC
AGGTTAACGAG -> GGTTAACGAGG
AGGTTGAGGAT -> GGTTGAGGATT
AGGTTTAAGCG -> GGTTTAAGCGC
AGTAAAGGCGC -> GTAAAGGCGCC
AGTAAATCGGT -> GTAAATCGGTA
AGTAATTCAAA -> GTAATTCAAAC
AGTAATTCCAT -> GTAATTCCATT
AGTACAGAGCT -> GTACAGAGCTA
AGTACCGACCG -> GTACCGACCGC
AGTACTTCTGC -> GTACTTCTGCT
AGTAGTTTCCT -> GTAGTTTCCTC
AGTATACCTAT -> GTATACCTATT
AGTCAACGATA -> GTCAACGATAA
AGTCACCCGAT -> GTCACCCGATC
AGTCCGTTAGG -> GTCCGTTAGGA
AGTCCTCCGCT -> GTCCTCCGCTG
AGTCCTTATCA -> GTCCTTATCAT
AGTCGACCTTG -> GTCGACCTTGT
AGTCGATCGTT -> GTCGATCGTTC
AGTCGCCGACT -> GTCGCCGACTA
AGTCGTACACC -> GTCGTACACCA
AGTCTATTGGG -> GTCTATTGGGC
AGTCTCCTGCG -> GTCTCCTGCGC
AGTGACCGATG -> GTGACCGATGT
AGTGAGCAGTA -> GTGAGCAGTAT
AGTGCCCCACA -> GTGCCCCACAC
AGTGGAGCGAT -> GTGGAGCGATA
AGTGGATACGA -> GTGGATACGAC
AGTGGGCTTTC -> GTGGGCTTTCG
AGTGTCACAGG -> GTGTCACAGGA
AGTTAACTTTG -> GTTAACTTTGC
AGTTAGAATGC -> GTTAGAATGCG
AGTTATCACCT -> GTTATCACCTT
AGTTCAAAAGT -> GTTCAAAAGTG
AGTTCGATATG -> GTTCGATATGC
AGTTCTTTTTC -> GTTCTTTTTCG
AGTTGGAACCA -> GTTGGAACCAT
AGTTTCCTCAA -> GTTTCCTCAAG
AGTTTGGGACA -> GTTTGGGACAA
ATAAAAGCGCG -> TAAAAGCGCGG
ATAAACCGGCC -> TAAACCGGCCA
ATAACATCCCT -> TAACATCCCTG
ATAACGCGTCC -> TAACGCGTCCC
ATAACTGATCT -> TAACTGATCTT
ATAAGAGGCTA -> TAAGAGGCTAT
ATAAGCAGGCC -> TAAGCAGGCCG
ATAAGCGATGG -> TAAGCGATGGC
ATAATGCAAGT -> TAATGCAAGTT
ATAATTCGCTG -> TAATTCGCTGA
ATACATCACCC -> TACATCACCCT
ATACCTATTGA -> TACCTATTGAC
ATACGAATCTT -> TACGAATCTTA
ATACGACCCCT -> TACGACCCCTC
ATACGGCTTTG -> TACGGCTTTGG
ATACTCCTGTT -> TACTCCTGTTA
ATACTGCGGGT -> TACTGCGGGTT
ATAGACAACCT -> TAGACAACCTT
ATAGCAGTCAC -> TAGCAGTCACC
ATAGGGACGCC -> TAGGGACGCCT
ATAGTCAACGA -> TAGTCAACGAT
ATAGTCCTTAT -> TAGTCCTTATC
ATATCACTGAT -> TATCACTGATC
ATATGATGATC -> TATGATGATCG
ATATGCAGCGA -> TATGCAGCGAA
ATATGGTAAAG -> TATGGTAAAGA
ATATTCACTGC -> TATTCACTGCA
ATATTCTTGCG -> TATTCTTGCGG
ATATTGGAAAC -> TATTGGAAACT
ATATTTCAATA -> TATTTCAATAG
ATATTTCAGGT -> TATTTCAGGTA
ATCAAACCCAG -> TCAAACCCAGC
ATCACCCTTGA -> TCACCCTTGAA
ATCACCTTCCA -> TCACCTTCCAT
ATCACTGATCT -> TCACTGATCTT
ATCACTTGGTC -> TCACTTGGTCG
ATCAGTCCTCC -> TCAGTCCTCCG
ATCATGGCATC -> TCATGGCATCG
ATCATTATTTA -> TCATTATTTAG
ATCCATGTGAA -> TCCATGTGAAT
ATCCCTGTGAC -> TCCCTGTGACT
ATCCGTGGTAC -> TCCGTGGTACC
ATCCTAATACT -> TCCTAATACTG
ATCGAGTCTCC -> TCGAGTCTCCT
ATCGATTTTCG -> TCGATTTTCGA
ATCGCACTCGC -> TCGCACTCGCC
ATCGGCTGATT -> TCGGCTGATTT
ATCGGTAAAAG -> TCGGTAAAAGA
ATCGGTATTGA -> TCGGTATTGAA
ATCGTCGCAAT -> TCGTCGCAATT
ATCGTCGGTAT -> TCGTCGGTATT
ATCGTGCAGAT -> TCGTGCAGATA
ATCGTTCTCAA -> TCGTTCTCAAG
ATCGTTGCTTC -> TCGTTGCTTCA
ATCTATGATCA -> TCTATGATCAA
ATCTCTATGCT -> TCTCTATGCTC
ATCTTACGTGA -> TCTTACGTGAG
ATCTTTAAGCT -> TCTTTAAGCTT
ATCTTTTCTGC -> TCTTTTCTGCC
ATGAGATGTAC -> TGAGATGTACC
ATGATAAACCG -> TGATAAACCGG
ATGATCAAACC -> TGATCAAACCC
ATGATCGTCGC -> TGATCGTCGCA
ATGATGATCGT -> TGATGATCGTC
ATGATTCAATA -> TGATTCAATAC
ATGCAAGTTAA -> TGCAAGTTAAC
ATGCAGCGAAA -> TGCAGCGAAAG
ATGCAGGGGTC -> TGCAGGGGTCC
ATGCGCAGCGT -> TGCGCAGCGTG
ATGCGCCACAC -> TGCGCCACACC
ATGCGGATCGA -> TGCGGATCGAT
ATGCGGATGCA -> TGCGGATGCAG
ATGCGGCGGTG -> TGCGGCGGTGC
ATGCGGTTAAC -> TGCGGTTAACT
ATGCTCCGCTC -> TGCTCCGCTCA
ATGGAGGGACC -> TGGAGGGACCC
ATGGATATTTC -> TGGATATTTCA
ATGGCATCGTG -> TGGCATCGTGC
ATGGCCCGTCA -> TGGCCCGTCAC
ATGGCGTGTAC -> TGGCGTGTACG
ATGGCTGCCCG -> TGGCTGCCCGC
ATGGGGGCTTG -> TGGGGGCTTGT
ATGGTAAAGAG -> TGGTAAAGAGA
ATGGTCCCCGA -> TGGTCCCCGAT
ATGGTCGAGCT -> TGGTCGAGCTA
ATGTACCTATG -> TGTACCTATGT
ATGTACTACGA -> TGTACTACGAG
ATGTACTTAAA -> TGTACTTAAAC
ATGTGAACATG -> TGTGAACATGG
ATGTGAATACA -> TGTGAATACAT
ATGTGAATATG -> TGTGAATATGA
ATGTGGTAGTT -> TGTGGTAGTTC
ATGTTCGTTGT -> TGTTCGTTGTC
ATTACAACGAT -> TTACAACGATC
ATTAGACAGAT -> TTAGACAGATT
ATTAGACATAT -> TTAGACATATG
ATTAGTAAATC -> TTAGTAAATCG
ATTATAACATC -> TTATAACATCC
ATTATTTAGTT -> TTATTTAGTTC
ATTCAAACCGA -> TTCAAACCGAA
ATTCAATACTC -> TTCAATACTCC
ATTCACGACCC -> TTCACGACCCT
ATTCACTGCAT -> TTCACTGCATC
ATTCCAAAATC -> TTCCAAAATCG
ATTCCATTGAC -> TTCCATTGACC
ATTCGCTGAAG -> TTCGCTGAAGC
ATTCTGCGCTT -> TTCTGCGCTTG
ATTCTTACAAC -> TTCTTACAACA
ATTCTTGCGGT -> TTCTTGCGGTG
ATTGAAGCCCT -> TTGAAGCCCTA
ATTGACCAGGG -> TTGACCAGGGA
ATTGACGTGTG -> TTGACGTGTGG
ATTGAGCACGT -> TTGAGCACGTA
ATTGGAAACTC -> TTGGAAACTCT
ATTGGGCGATA -> TTGGGCGATAA
ATTGTGAGCTC -> TTGTGAGCTCG
ATTTAGATTCT -> TTTAGATTCTT
ATTTAGTGGAG -> TTTAGTGGAGC
ATTTAGTTCTT -> TTTAGTTCTTT
ATTTCAATAGG -> TTTCAATAGGG
ATTTCAGGTAA -> TTTCAGGTAAA
ATTTCCGCGCG -> TTTCCGCGCGG
ATTTGTAAAAA -> TTTGTAAAAAA
ATTTGTAATGG -> TTTGTAATGGA
ATTTTCACCGA -> TTTTCACCGAG
ATTTTCCCCTG -> TTTTCCCCTGA
ATTTTCGACCA -> TTTTCGACCAA
CAAAACGTCGA -> AAAACGTCGAC
CAAAAGTGCCC -> AAAAGTGCCCC
CAAAATCGGCT -> AAAATCGGCTG
CAAAATGATTC -> AAAATGATTCA
CAAACCCAGCA -> AAACCCAGCAA
CAAACCCCTAG -> AAACCCCTAGG
CAAACCGAACA -> AAACCGAACAG
CAAACTGTACA -> AAACTGTACAC
CAACAGAAACT -> AACAGAAACTC
CAACAGGATGC -> AACAGGATGCG
CAACCTTAGGG -> AACCTTAGGGA
CAACGATAAGC -> AACGATAAGCA
CAACGATCTAT -> AACGATCTATG
CAACTGTGCAT -> AACTGTGCATA
CAAGCAGTAAA -> AAGCAGTAAAG
CAAGCGGGGTG -> AAGCGGGGTGG
CAAGGAAACTC -> AAGGAAACTCC
CAAGGCCGTCA -> AAGGCCGTCAG
CAAGGTCGTTT -> AAGGTCGTTTC
CAAGTGACCGA -> AAGTGACCGAT
CAAGTGGGCTT -> AAGTGGGCTTT
CAAGTTAACTT -> AAGTTAACTTT
CAATACTCCTG -> AATACTCCTGT
CAATAGGGACG -> AATAGGGACGC
CAATCCGTGGT -> AATCCGTGGTA
CAATCGAGTCT -> AATCGAGTCTC
CAATTAGACAG -> AATTAGACAGA
CACAAAACGTC -> ACAAAACGTCG
CACAAACCCCT -> ACAAACCCCTA
CACACAAAACG -> ACACAAAACGT
CACACCGAGGT -> ACACCGAGGTT
CACAGGAGAGC -> ACAGGAGAGCT
CACCATTTAGA -> ACCATTTAGAT
CACCCGATCGG -> ACCCGATCGGT
CACCCTTGAAC -> ACCCTTGAACC
CACCGAGGTTT -> ACCGAGGTTTA
CACCGAGTTGG -> ACCGAGTTGGA
CACCGCATAAC -> ACCGCATAACG
CACCGGATGTT -> ACCGGATGTTC
CACCTAAACCA -> ACCTAAACCAT
CACCTACATGA -> ACCTACATGAT
CACCTTCCATG -> ACCTTCCATGC
CACGACAGAAA -> ACGACAGAAAA
CACGACCCTTG -> ACGACCCTTGT
CACGGACATGG -> ACGGACATGGC
CACGTAAAAAG -> ACGTAAAAAGT
CACTACAACTG -> ACTACAACTGT
CACTAGTAATT -> ACTAGTAATTC
CACTCGCCTCG -> ACTCGCCTCGC
CACTCGTAAGA -> ACTCGTAAGAA
CACTGATCTTT -> ACTGATCTTTT
CACTGCATCAT -> ACTGCATCATT
CACTGTTTTAG -> ACTGTTTTAGG
CACTTCCGATG -> ACTTCCGATGC
CACTTGGTCGA -> ACTTGGTCGAT
CACTTTTAGTC -> ACTTTTAGTCG
CAGAAAAGTGG -> AGAAAAGTGGA
CAGAAACTCTC -> AGAAACTCTCT
CAGACCAGAGT -> AGACCAGAGTT
CAGAGCTATCC -> AGAGCTATCCT
CAGAGTTATCA -> AGAGTTATCAC
CAGATATTCAC -> AGATATTCACT
CAGATGGCCCG -> AGATGGCCCGT
CAGATTCTGCG -> AGATTCTGCGC
CAGCAAGGAAA -> AGCAAGGAAAC
CAGCCTGACAT -> AGCCTGACATC
CAGCGAAAGCC -> AGCGAAAGCCC
CAGCGTGGGTC -> AGCGTGGGTCG
CAGGAGAGCTT -> AGGAGAGCTTC
CAGGATGCGGT -> AGGATGCGGTT
CAGGCCGAGCC -> AGGCCGAGCCG
CAGGGACTTAT -> AGGGACTTATC
CAGGGGTCCTC -> AGGGGTCCTCC
CAGGTAAATAG -> AGGTAAATAGT
CAGTAAAGGCG -> AGTAAAGGCGC
CAGTAATTCAA -> AGTAATTCAAA
CAGTACTTCTG -> AGTACTTCTGC
CAGTATACCTA -> AGTATACCTAT
CAGTCACCCGA -> AGTCACCCGAT
CAGTCCTCCGC -> AGTCCTCCGCT
CAGTCTATTGG -> AGTCTATTGGG
CAGTGTCACAG -> AGTGTCACAGG
CAGTTAGAATG -> AGTTAGAATGC
CATAAAAGCGC -> ATAAAAGCGCG
CATAACGCGTC -> ATAACGCGTCC
CATAATGCAAG -> ATAATGCAAGT
CATACGAATCT -> ATACGAATCTT
CATAGTCAACG -> ATAGTCAACGA
CATATGGTAAA -> ATATGGTAAAG
CATATTCTTGC -> ATATTCTTGCG
CATCACCCTTG -> ATCACCCTTGA
CATCACTTGGT -> ATCACTTGGTC
CATCATTATTT -> ATCATTATTTA
CATCCCTGTGA -> ATCCCTGTGAC
CATCGCACTCG -> ATCGCACTCGC
CATCGTGCAGA -> ATCGTGCAGAT
CATCTCTATGC -> ATCTCTATGCT
CATGATAAACC -> ATGATAAACCG
CATGCGCCACA -> ATGCGCCACAC
CATGCGGATGC -> ATGCGGATGCA
CATGGCATCGT -> ATGGCATCGTG
CATGGCGTGTA -> ATGGCGTGTAC
CATGGGGGCTT -> ATGGGGGCTTG
CATGGTCCCCG -> ATGGTCCCCGA
CATGGTCGAGC -> ATGGTCGAGCT
CATGTACTACG -> ATGTACTACGA
CATGTGAATAC -> ATGTGAATACA
CATTATTTAGT -> ATTATTTAGTT
CATTGACCAGG -> ATTGACCAGGG
CATTGTGAGCT -> ATTGTGAGCTC
CATTTAGATTC -> ATTTAGATTCT
CCAAAATCGGC -> CAAAATCGGCT
CCAAACTGTAC -> CAAACTGTACA
CCAAGCAGTAA -> CAAGCAGTAAA
CCAAGTGACCG -> CAAGTGACCGA
CCACACAAAAC -> CACACAAAACG
CCACACCGAGG -> CACACCGAGGT
CCACGACAGAA -> CACGACAGAAA
CCACTCGTAAG -> CACTCGTAAGA
CCAGACCAGAG -> CAGACCAGAGT
CCAGAGTTATC -> CAGAGTTATCA
CCAGCAAGGAA -> CAGCAAGGAAA
CCAGGGACTTA -> CAGGGACTTAT
CCATCACTTGG -> CATCACTTGGT
CCATGCGCCAC -> CATGCGCCACA
CCATGGGGGCT -> CATGGGGGCTT
CCATGTGAATA -> CATGTGAATAC
CCATTGACCAG -> CATTGACCAGG
CCATTGTGAGC -> CATTGTGAGCT
CCATTTAGATT -> CATTTAGATTC
CCCACACAAAA -> CCACACAAAAC
CCCAGACCAGA -> CCAGACCAGAG
CCCAGCAAGGA -> CCAGCAAGGAA
CCCCACACAAA -> CCCACACAAAA
CCCCCTCATGT -> CCCCTCATGTA
CCCCGATTTTC -> CCCGATTTTCC
CCCCTAGGTTG -> CCCTAGGTTGA
CCCCTCACCTA -> CCCTCACCTAC
CCCCTCAGCCT -> CCCTCAGCCTG
CCCCTCATGTA -> CCCTCATGTAC
CCCCTGATTCC -> CCCTGATTCCA
CCCGATCGGTA -> CCGATCGGTAT
CCCGATTTTCC -> CCGATTTTCCC
CCCGCGAGACA -> CCGCGAGACAA
CCCGCGTGCGT -> CCGCGTGCGTT
CCCGCTAGTAC -> CCGCTAGTACA
CCCGTCACCGG -> CCGTCACCGGA
CCCGTCTAGTT -> CCGTCTAGTTC
CCCTAAGAATC -> CCTAAGAATCG
CCCTAATGTGA -> CCTAATGTGAA
CCCTAGGTGGT -> CCTAGGTGGTA
CCCTAGGTTGA -> CCTAGGTTGAG
CCCTCACCTAC -> CCTCACCTACA
CCCTCAGCCTG -> CCTCAGCCTGA
CCCTCATGTAC -> CCTCATGTACT
CCCTCCTAAAG -> CCTCCTAAAGA
CCCTGATTCCA -> CCTGATTCCAA
CCCTGTGACTG -> CCTGTGACTGG
CCCTTGAACCG -> CCTTGAACCGC
CCCTTGTCACT -> CCTTGTCACTT
CCGAACAGTGT -> CGAACAGTGTC
CCGAAGTAGTT -> CGAAGTAGTTT
CCGACCGCCCC -> CGACCGCCCCT
CCGACTATTCA -> CGACTATTCAC
CCGAGCCGGTA -> CGAGCCGGTAG
CCGAGGTTTAA -> CGAGGTTTAAG
CCGAGTTGGAA -> CGAGTTGGAAC
CCGATAGCAGT -> CGATAGCAGTC
CCGATCGGTAT -> CGATCGGTATT
CCGATGCGGAT -> CGATGCGGATC
CCGATGTGGTA -> CGATGTGGTAG
CCGATTTTCCC -> CGATTTTCCCC
CCGCATAACGC -> CGCATAACGCG
CCGCCCCTCAC -> CGCCCCTCACC
CCGCCTCGCGG -> CGCCTCGCGGA
CCGCGAGACAA -> CGCGAGACAAG
CCGCGCGGTAT -> CGCGCGGTATT
CCGCGTCCAAG -> CGCGTCCAAGT
CCGCGTGCGTT -> CGCGTGCGTTT
CCGCTAGTACA -> CGCTAGTACAG
CCGCTCATAGT -> CGCTCATAGTC
CCGCTGGCGGT -> CGCTGGCGGTT
CCGGATGTTCG -> CGGATGTTCGT
CCGGCCACTCG -> CGGCCACTCGT
CCGGGGACGGG -> CGGGGACGGGT
CCGGTAGTCGC -> CGGTAGTCGCC
CCGTCACCGGA -> CGTCACCGGAT
CCGTCAGTCTA -> CGTCAGTCTAT
CCGTCTAGTTC -> CGTCTAGTTCG
CCGTGGTACCG -> CGTGGTACCGC
CCGTTAGGACC -> CGTTAGGACCA
CCTAAACCATC -> CTAAACCATCA
CCTAAAGAAGT -> CTAAAGAAGTT
CCTAAGAATCG -> CTAAGAATCGT
CCTAATACTGC -> CTAATACTGCG
CCTAATGTGAA -> CTAATGTGAAT
CCTACACTTTT -> CTACACTTTTA
CCTACATGATA -> CTACATGATAA
CCTAGGTGGTA -> CTAGGTGGTAA
CCTAGGTTGAG -> CTAGGTTGAGG
CCTATCAGTCC -> CTATCAGTCCT
CCTATGTGAAC -> CTATGTGAACA
CCTATTGACGT -> CTATTGACGTG
CCTATTTCCGC -> CTATTTCCGCG
CCTCAAGGCCG -> CTCAAGGCCGT
CCTCACCTACA -> CTCACCTACAT
CCTCAGCCTGA -> CTCAGCCTGAC
CCTCATGTACT -> CTCATGTACTA
CCTCCATGGGG -> CTCCATGGGGG
CCTCCGCTGGC -> CTCCGCTGGCG
CCTCCTAAAGA -> CTCCTAAAGAA
CCTCGCCTATC -> CTCGCCTATCA
CCTCGCGGAGG -> CTCGCGGAGGG
CCTGACATCGC -> CTGACATCGCA
CCTGATTCCAA -> CTGATTCCAAA
CCTGCGCTCCA -> CTGCGCTCCAT
CCTGTGACTGG -> CTGTGACTGGG
CCTGTTAACGA -> CTGTTAACGAT
CCTTAGGGATA -> CTTAGGGATAC
CCTTATCATGG -> CTTATCATGGC
CCTTCCATGCG -> CTTCCATGCGC
CCTTGAACCGC -> CTTGAACCGCC
CCTTGCAGTAC -> CTTGCAGTACT
CCTTGGCGGGA -> CTTGGCGGGAA
CCTTGTCACTT -> CTTGTCACTTC
CCTTGTCCACG -> CTTGTCCACGA
CGAAAGCCCGC -> GAAAGCCCGCG
CGAACAGTGTC -> GAACAGTGTCA
CGAAGTAGTTT -> GAAGTAGTTTC
CGAATCTTACG -> GAATCTTACGT
CGACAATCGAG -> GACAATCGAGT
CGACAGAAAAG -> GACAGAAAAGT
CGACCAAGCAG -> GACCAAGCAGT
CGACCCCTCAG -> GACCCCTCAGC
CGACCCTTGTC -> GACCCTTGTCA
CGACCGCCCCT -> GACCGCCCCTC
CGACCTTGTCC -> GACCTTGTCCA
CGACGTGATGT -> GACGTGATGTA
CGACTATTCAC -> GACTATTCACG
CGAGACAAGGT -> GAGACAAGGTC
CGAGACAGATG -> GAGACAGATGG
CGAGCCGGTAG -> GAGCCGGTAGT
CGAGCGATAGA -> GAGCGATAGAC
CGAGCTAAATT -> GAGCTAAATTA
CGAGGTACGGC -> GAGGTACGGCG
CGAGGTTTAAG -> GAGGTTTAAGC
CGAGTACCGAC -> GAGTACCGACC
CGAGTCGACCT -> GAGTCGACCTT
CGAGTCTCCTG -> GAGTCTCCTGC
CGAGTGAGCAG -> GAGTGAGCAGT
CGAGTTGGAAC -> GAGTTGGAACC
CGATAACTGAT -> GATAACTGATC
CGATAAGAGGC -> GATAAGAGGCT
CGATAAGCAGG -> GATAAGCAGGC
CGATAAGCGAT -> GATAAGCGATG
CGATAGACAAC -> GATAGACAACC
CGATAGCAGTC -> GATAGCAGTCA
CGATATGCAGC -> GATATGCAGCG
CGATATTGGAA -> GATATTGGAAA
CGATCGGTATT -> GATCGGTATTG
CGATCGTTCTC -> GATCGTTCTCA
CGATCTATGAT -> GATCTATGATC
CGATGCGGATC -> GATGCGGATCG
CGATGGCTGCC -> GATGGCTGCCC
CGATGTGGTAG -> GATGTGGTAGT
CGATTGAGCAC -> GATTGAGCACG
CGATTTTCCCC -> GATTTTCCCCT
CGATTTTCGAC -> GATTTTCGACC
CGCAATTAGAC -> GCAATTAGACA
CGCACCGCATA -> GCACCGCATAA
CGCACTCGCCT -> GCACTCGCCTC
CGCACTGTTTT -> GCACTGTTTTA
CGCAGCGTGGG -> GCAGCGTGGGT
CGCATAACGCG -> GCATAACGCGT
CGCCACACCGA -> GCCACACCGAG
CGCCCCTCACC -> GCCCCTCACCT
CGCCGACTATT -> GCCGACTATTC
CGCCGATAGCA -> GCCGATAGCAG
CGCCTACACTT -> GCCTACACTTT
CGCCTATCAGT -> GCCTATCAGTC
CGCCTCGCCTA -> GCCTCGCCTAT
CGCCTCGCGGA -> GCCTCGCGGAG
CGCCTTGCAGT -> GCCTTGCAGTA
CGCGACAATCG -> GCGACAATCGA
CGCGAGACAAG -> GCGAGACAAGG
CGCGCACCGCA -> GCGCACCGCAT
CGCGCGGTATT -> GCGCGGTATTA
CGCGGAGGGCG -> GCGGAGGGCGC
CGCGGTATTAG -> GCGGTATTAGT
CGCGGTTAAGC -> GCGGTTAAGCA
CGCGTCCAAGT -> GCGTCCAAGTG
CGCGTCCCGTC -> GCGTCCCGTCT
CGCGTGCGTTT -> GCGTGCGTTTG
CGCTAGTACAG -> GCTAGTACAGA
CGCTCATAGTC -> GCTCATAGTCA
CGCTCCATAAA -> GCTCCATAAAC
CGCTGAAGCAA -> GCTGAAGCAAC
CGCTGGCGGTT -> GCTGGCGGTTG
CGCTTGTAGGA -> GCTTGTAGGAC
CGCTTGTCTTC -> GCTTGTCTTCG
CGGACATGGCG -> GGACATGGCGT
CGGAGGGCGCA -> GGAGGGCGCAC
CGGATCGATTT -> GGATCGATTTT
CGGATGCAGGG -> GGATGCAGGGG
CGGATGTTCGT -> GGATGTTCGTT
CGGCCACTCGT -> GGCCACTCGTA
CGGCGCTTGTA -> GGCGCTTGTAG
CGGCGGTGCGC -> GGCGGTGCGCC
CGGCTGATTTG -> GGCTGATTTGT
CGGCTTTGGTG -> GGCTTTGGTGA
CGGGAATCCAT -> GGGAATCCATG
CGGGGACGGGT -> GGGGACGGGTG
CGGGGGTCGTA -> GGGGGTCGTAA
CGGGGTATGCG -> GGGGTATGCGG
CGGGGTGGCGG -> GGGGTGGCGGG
CGGGTCCTTGG -> GGGTCCTTGGC
CGGGTGGTAAG -> GGGTGGTAAGG
CGGGTTGGCAG -> GGGTTGGCAGT
CGGTAAAAGAA -> GGTAAAAGAAA
CGGTAGTCGCC -> GGTAGTCGCCG
CGGTATTAGTA -> GGTATTAGTAA
CGGTATTGAAG -> GGTATTGAAGC
CGGTATTTGTA -> GGTATTTGTAA
CGGTATTTTCA -> GGTATTTTCAC
CGGTGAACTTT -> GGTGAACTTTG
CGGTGCGCCGA -> GGTGCGCCGAT
CGGTTAACTTC -> GGTTAACTTCA
CGGTTAAGCAT -> GGTTAAGCATG
CGGTTCATAAT -> GGTTCATAATG
CGGTTGGTGAG -> GGTTGGTGAGA
CGTAAAAAGTC -> GTAAAAAGTCG
CGTAAGAAAAT -> GTAAGAAAATG
CGTAAGGAGGG -> GTAAGGAGGGA
CGTACACCATT -> GTACACCATTT
CGTACATACGA -> GTACATACGAA
CGTCACCGGAT -> GTCACCGGATG
CGTCAGTCTAT -> GTCAGTCTATT
CGTCCAAGTGA -> GTCCAAGTGAC
CGTCCCGTCTA -> GTCCCGTCTAG
CGTCGACGTGA -> GTCGACGTGAT
CGTCGCAATTA -> GTCGCAATTAG
CGTCGGTATTT -> GTCGGTATTTG
CGTCTAGTTCG -> GTCTAGTTCGA
CGTGAGATTAC -> GTGAGATTACA
CGTGAGGGGCG -> GTGAGGGGCGG
CGTGATGTACT -> GTGATGTACTT
CGTGCAGATAT -> GTGCAGATATT
CGTGCGAGTCG -> GTGCGAGTCGA
CGTGCGTGAGG -> GTGCGTGAGGG
CGTGCGTTTGT -> GTGCGTTTGTT
CGTGGGTCGTG -> GTGGGTCGTGT
CGTGGTACCGC -> GTGGTACCGCG
CGTGTACGAGT -> GTGTACGAGTA
CGTGTGGTTTT -> GTGTGGTTTTT
CGTGTGTTCAC -> GTGTGTTCACA
CGTTAGGACCA -> GTTAGGACCAA
CGTTCTCAAGT -> GTTCTCAAGTG
CGTTGCTTCAA -> GTTGCTTCAAT
CGTTGTCTTGC -> GTTGTCTTGCA
CGTTTCCCAGA -> GTTTCCCAGAC
CGTTTGTTGCG -> GTTTGTTGCGT
CTAAACCATCA -> TAAACCATCAC
CTAAAGAAGTT -> TAAAGAAGTTT
CTAAAGAGTCC -> TAAAGAGTCCG
CTAAATTATAA -> TAAATTATAAC
CTAACTGAAAC -> TAACTGAAACA
CTAAGAATCGT -> TAAGAATCGTT
CTAATACTGCG -> TAATACTGCGG
CTAATGTGAAT -> TAATGTGAATA
CTACAACTGTG -> TACAACTGTGC
CTACACTTTTA -> TACACTTTTAG
CTACATGATAA -> TACATGATAAA
CTACGAGTGAG -> TACGAGTGAGC
CTACTGCGTGC -> TACTGCGTGCG
CTAGGTGGTAA -> TAGGTGGTAAC
CTAGGTTGAGG -> TAGGTTGAGGA
CTAGTAATTCC -> TAGTAATTCCA
CTAGTACAGAG -> TAGTACAGAGC
CTAGTTCGATA -> TAGTTCGATAT
CTATATCACTG -> TATATCACTGA
CTATCAGTCCT -> TATCAGTCCTC
CTATCCTAATA -> TATCCTAATAC
CTATGATCAAA -> TATGATCAAAC
CTATGCTCCGC -> TATGCTCCGCT
CTATGTGAACA -> TATGTGAACAT
CTATTCACGAC -> TATTCACGACC
CTATTGACGTG -> TATTGACGTGT
CTATTGGGCGA -> TATTGGGCGAT
CTATTTCCGCG -> TATTTCCGCGC
CTCAAGGCCGT -> TCAAGGCCGTC
CTCAAGTGGGC -> TCAAGTGGGCT
CTCACCTACAT -> TCACCTACATG
CTCAGCCTGAC -> TCAGCCTGACA
CTCATAGTCAA -> TCATAGTCAAC
CTCATGTACTA -> TCATGTACTAC
CTCCATGGGGG -> TCCATGGGGGC
CTCCGCTCATA -> TCCGCTCATAG
CTCCGCTGGCG -> TCCGCTGGCGG
CTCCGGGGACG -> TCCGGGGACGG
CTCCTAAAGAA -> TCCTAAAGAAG
CTCCTGCGCTC -> TCCTGCGCTCC
CTCCTGTTAAC -> TCCTGTTAACG
CTCGCCTATCA -> TCGCCTATCAG
CTCGCCTCGCC -> TCGCCTCGCCT
CTCGCGACAAT -> TCGCGACAATC
CTCGCGGAGGG -> TCGCGGAGGGC
CTCGTAAGAAA -> TCGTAAGAAAA
CTCTACTGCGT -> TCTACTGCGTG
CTCTATGCTCC -> TCTATGCTCCG
CTCTCTACTGC -> TCTCTACTGCG
CTCTTCATGGT -> TCTTCATGGTC
CTGAAACATAT -> TGAAACATATT
CTGAAGCAACA -> TGAAGCAACAG
CTGACATCGCA -> TGACATCGCAC
CTGATCTTTAA -> TGATCTTTAAG
CTGATCTTTTC -> TGATCTTTTCT
CTGATTCCAAA -> TGATTCCAAAA
CTGATTTGTAA -> TGATTTGTAAA
CTGCATCATTA -> TGCATCATTAT
CTGCCCGCTAG -> TGCCCGCTAGT
CTGCCGAAGTA -> TGCCGAAGTAG
CTGCGCTCCAT -> TGCGCTCCATA
CTGCGCTTGTC -> TGCGCTTGTCT
CTGCGGGTTGG -> TGCGGGTTGGC
CTGCGTGCGAG -> TGCGTGCGAGT
CTGCTGGATAA -> TGCTGGATAAT
CTGGATAATTC -> TGGATAATTCG
CTGGCGGTTGG -> TGGCGGTTGGT
CTGGGCACGGA -> TGGGCACGGAC
CTGTACACCTA -> TGTACACCTAA
CTGTGACTGGG -> TGTGACTGGGC
CTGTGCATAAA -> TGTGCATAAAA
CTGTTAACGAT -> TGTTAACGATT
CTGTTTTAGGA -> TGTTTTAGGAA
CTTAAACCCTA -> TTAAACCCTAG
CTTACAACAGA -> TTACAACAGAA
CTTACGTGAGA -> TTACGTGAGAT
CTTAGGGATAC -> TTAGGGATACG
CTTATCATGGC -> TTATCATGGCA
CTTATCGTCGG -> TTATCGTCGGT
CTTCAATCCGT -> TTCAATCCGTG
CTTCACTAGTA -> TTCACTAGTAA
CTTCATGGTCG -> TTCATGGTCGA
CTTCCATGCGC -> TTCCATGCGCC
CTTCCGATGCG -> TTCCGATGCGG
CTTCGAGACAG -> TTCGAGACAGA
CTTCGATAACT -> TTCGATAACTG
CTTCTGCTGGA -> TTCTGCTGGAT
CTTGAACCGCC -> TTGAACCGCCT
CTTGCAGTACT -> TTGCAGTACTT
CTTGCAGTTAG -> TTGCAGTTAGA
CTTGCGGTGAA -> TTGCGGTGAAC
CTTGGCGGGAA -> TTGGCGGGAAT
CTTGGTCGATA -> TTGGTCGATAT
CTTGTAGGACA -> TTGTAGGACAA
CTTGTCACTTC -> TTGTCACTTCC
CTTGTCCACGA -> TTGTCCACGAC
CTTGTCTTCGA -> TTGTCTTCGAT
CTTGTGTCCTA -> TTGTGTCCTAT
CTTTAAGCTTT -> TTTAAGCTTTG
CTTTCGGGGTA -> TTTCGGGGTAT
CTTTGAGCTAA -> TTTGAGCTAAC
CTTTGCTAAAG -> TTTGCTAAAGA
CTTTGGATATT -> TTTGGATATTT
CTTTGGTGACA -> TTTGGTGACAT
CTTTTAGTCGT -> TTTTAGTCGTA
CTTTTCTGCCG -> TTTTCTGCCGA
CTTTTTCGGGG -> TTTTTCGGGGG
GAAAAGTGGAT -> AAAAGTGGATA
GAAAATGAGAT -> AAAATGAGATG
GAAACATATTC -> AAACATATTCT
GAAACCCTCCT -> AAACCCTCCTA
GAAACTCCGGG -> AAACTCCGGGG
GAAACTCTCTA -> AAACTCTCTAC
GAAACTCTTCA -> AAACTCTTCAT
GAAAGCCCGCG -> AAAGCCCGCGT
GAACAGTGTCA -> AACAGTGTCAC
GAACATGGTCC -> AACATGGTCCC
GAACCATTGTG -> AACCATTGTGA
GAACCGCCTCG -> AACCGCCTCGC
GAACGGTATTT -> AACGGTATTTT
GAACTTTGGAT -> AACTTTGGATA
GAAGCAACAGG -> AAGCAACAGGA
GAAGCCCCCTC -> AAGCCCCCTCA
GAAGCCCTAAT -> AAGCCCTAATG
GAAGGCGTGCG -> AAGGCGTGCGT
GAAGTAGTTTC -> AAGTAGTTTCC
GAAGTTTGGGA -> AAGTTTGGGAC
GAATACATCAC -> AATACATCACC
GAATATGATGA -> AATATGATGAT
GAATCCATGTG -> AATCCATGTGA
GAATCGTTGCT -> AATCGTTGCTT
GAATCTTACGT -> AATCTTACGTG
GAATGCGCAGC -> AATGCGCAGCG
GAATTTAGTGG -> AATTTAGTGGA
GACAAAATGAT -> ACAAAATGATT
GACAACCTTAG -> ACAACCTTAGG
GACAAGCGGGG -> ACAAGCGGGGT
GACAAGGTCGT -> ACAAGGTCGTT
GACAATCGAGT -> ACAATCGAGTC
GACAGAAAAGT -> ACAGAAAAGTG
GACAGATGGCC -> ACAGATGGCCC
GACAGATTCTG -> ACAGATTCTGC
GACATATGGTA -> ACATATGGTAA
GACATCGCACT -> ACATCGCACTC
GACATCTCTAT -> ACATCTCTATG
GACATGGCGTG -> ACATGGCGTGT
GACCAAACTGT -> ACCAAACTGTA
GACCAAGCAGT -> ACCAAGCAGTA
GACCAGAGTTA -> ACCAGAGTTAT
GACCAGGGACT -> ACCAGGGACTT
GACCCCTCAGC -> ACCCCTCAGCC
GACCCGCGAGA -> ACCCGCGAGAC
GACCCTAAGAA -> ACCCTAAGAAT
GACCCTTGTCA -> ACCCTTGTCAC
GACCGATGTGG -> ACCGATGTGGT
GACCGCCCCTC -> ACCGCCCCTCA
GACCTTGTCCA -> ACCTTGTCCAC
GACGCCTACAC -> ACGCCTACACT
GACGGGTGGTA -> ACGGGTGGTAA
GACGTGATGTA -> ACGTGATGTAC
GACGTGTGGTT -> ACGTGTGGTTT
GACTATTCACG -> ACTATTCACGA
GACTGGGCACG -> ACTGGGCACGG
GACTTATCGTC -> ACTTATCGTCG
GAGAAGGCGTG -> AGAAGGCGTGC
GAGAATTTAGT -> AGAATTTAGTG
GAGACAAGGTC -> AGACAAGGTCG
GAGACAGATGG -> AGACAGATGGC
GAGAGCTTCGA -> AGAGCTTCGAG
GAGAGGGTAGA -> AGAGGGTAGAA
GAGATGTACCT -> AGATGTACCTA
GAGATTACAAC -> AGATTACAACG
GAGCACGTAAA -> AGCACGTAAAA
GAGCAGTATAC -> AGCAGTATACC
GAGCCGGTAGT -> AGCCGGTAGTC
GAGCGATAAGA -> AGCGATAAGAG
GAGCGATAGAC -> AGCGATAGACA
GAGCTAAATTA -> AGCTAAATTAT
GAGCTAACTGA -> AGCTAACTGAA
GAGCTATCCTA -> AGCTATCCTAA
GAGCTCGCGAC -> AGCTCGCGACA
GAGCTTCGAGA -> AGCTTCGAGAC
GAGGATTAGAC -> AGGATTAGACA
GAGGCTATATC -> AGGCTATATCA
GAGGGACCCTA -> AGGGACCCTAA
GAGGGAGAAGG -> AGGGAGAAGGC
GAGGGCGCACT -> AGGGCGCACTG
GAGGGGCGGTT -> AGGGGCGGTTC
GAGGGTAGAAC -> AGGGTAGAACG
GAGGTACGGCG -> AGGTACGGCGC
GAGGTTAACGA -> AGGTTAACGAG
GAGGTTTAAGC -> AGGTTTAAGCG
GAGTACCGACC -> AGTACCGACCG
GAGTCCGTTAG -> AGTCCGTTAGG
GAGTCGACCTT -> AGTCGACCTTG
GAGTCTCCTGC -> AGTCTCCTGCG
GAGTGAGCAGT -> AGTGAGCAGTA
GAGTTATCACC -> AGTTATCACCT
GAGTTGGAACC -> AGTTGGAACCA
GATAAACCGGC -> ATAAACCGGCC
GATAACTGATC -> ATAACTGATCT
GATAAGAGGCT -> ATAAGAGGCTA
GATAAGCAGGC -> ATAAGCAGGCC
GATAAGCGATG -> ATAAGCGATGG
GATAATTCGCT -> ATAATTCGCTG
GATACGACCCC -> ATACGACCCCT
GATACGGCTTT -> ATACGGCTTTG
GATAGACAACC -> ATAGACAACCT
GATAGCAGTCA -> ATAGCAGTCAC
GATATGCAGCG -> ATATGCAGCGA
GATATTCACTG -> ATATTCACTGC
GATATTGGAAA -> ATATTGGAAAC
GATATTTCAAT -> ATATTTCAATA
GATATTTCAGG -> ATATTTCAGGT
GATCAAACCCA -> ATCAAACCCAG
GATCGATTTTC -> ATCGATTTTCG
GATCGGTATTG -> ATCGGTATTGA
GATCGTCGCAA -> ATCGTCGCAAT
GATCGTTCTCA -> ATCGTTCTCAA
GATCTATGATC -> ATCTATGATCA
GATCTTTAAGC -> ATCTTTAAGCT
GATCTTTTCTG -> ATCTTTTCTGC
GATGATCGTCG -> ATGATCGTCGC
GATGCAGGGGT -> ATGCAGGGGTC
GATGCGGATCG -> ATGCGGATCGA
GATGCGGTTAA -> ATGCGGTTAAC
GATGGAGGGAC -> ATGGAGGGACC
GATGGCCCGTC -> ATGGCCCGTCA
GATGGCTGCCC -> ATGGCTGCCCG
GATGTACCTAT -> ATGTACCTATG
GATGTACTTAA -> ATGTACTTAAA
GATGTGGTAGT -> ATGTGGTAGTT
GATGTTCGTTG -> ATGTTCGTTGT
GATTACAACGA -> ATTACAACGAT
GATTAGACATA -> ATTAGACATAT
GATTCAATACT -> ATTCAATACTC
GATTCCAAAAT -> ATTCCAAAATC
GATTCTGCGCT -> ATTCTGCGCTT
GATTCTTACAA -> ATTCTTACAAC
GATTGAGCACG -> ATTGAGCACGT
GATTTGTAAAA -> ATTTGTAAAAA
GATTTTCCCCT -> ATTTTCCCCTG
GATTTTCGACC -> ATTTTCGACCA
GCAACAGGATG -> CAACAGGATGC
GCAAGGAAACT -> CAAGGAAACTC
GCAAGTTAACT -> CAAGTTAACTT
GCAATTAGACA -> CAATTAGACAG
GCACCGCATAA -> CACCGCATAAC
GCACGGACATG -> CACGGACATGG
GCACGTAAAAA -> CACGTAAAAAG
GCACTCGCCTC -> CACTCGCCTCG
GCACTGTTTTA -> CACTGTTTTAG
GCAGATATTCA -> CAGATATTCAC
GCAGCGAAAGC -> CAGCGAAAGCC
GCAGCGTGGGT -> CAGCGTGGGTC
GCAGGCCGAGC -> CAGGCCGAGCC
GCAGGGGTCCT -> CAGGGGTCCTC
GCAGTAAAGGC -> CAGTAAAGGCG
GCAGTAATTCA -> CAGTAATTCAA
GCAGTACTTCT -> CAGTACTTCTG
GCAGTATACCT -> CAGTATACCTA
GCAGTCACCCG -> CAGTCACCCGA
GCAGTTAGAAT -> CAGTTAGAATG
GCATAAAAGCG -> CATAAAAGCGC
GCATAACGCGT -> CATAACGCGTC
GCATCATTATT -> CATCATTATTT
GCATCGTGCAG -> CATCGTGCAGA
GCATGCGGATG -> CATGCGGATGC
GCCACACCGAG -> CCACACCGAGG
GCCACTCGTAA -> CCACTCGTAAG
GCCCCACACAA -> CCCCACACAAA
GCCCCCTCATG -> CCCCCTCATGT
GCCCCTCACCT -> CCCCTCACCTA
GCCCGCGTGCG -> CCCGCGTGCGT
GCCCGCTAGTA -> CCCGCTAGTAC
GCCCGTCACCG -> CCCGTCACCGG
GCCCTAATGTG -> CCCTAATGTGA
GCCGAAGTAGT -> CCGAAGTAGTT
GCCGACTATTC -> CCGACTATTCA
GCCGAGCCGGT -> CCGAGCCGGTA
GCCGATAGCAG -> CCGATAGCAGT
GCCGGTAGTCG -> CCGGTAGTCGC
GCCGTCAGTCT -> CCGTCAGTCTA
GCCTACACTTT -> CCTACACTTTT
GCCTATCAGTC -> CCTATCAGTCC
GCCTCGCCTAT -> CCTCGCCTATC
GCCTCGCGGAG -> CCTCGCGGAGG
GCCTGACATCG -> CCTGACATCGC
GCCTTGCAGTA -> CCTTGCAGTAC
GCGAAAGCCCG -> CGAAAGCCCGC
GCGACAATCGA -> CGACAATCGAG
GCGAGACAAGG -> CGAGACAAGGT
GCGAGTCGACC -> CGAGTCGACCT
GCGATAAGAGG -> CGATAAGAGGC
GCGATAAGCGA -> CGATAAGCGAT
GCGATAGACAA -> CGATAGACAAC
GCGATGGCTGC -> CGATGGCTGCC
GCGCACCGCAT -> CGCACCGCATA
GCGCACTGTTT -> CGCACTGTTTT
GCGCAGCGTGG -> CGCAGCGTGGG
GCGCCACACCG -> CGCCACACCGA
GCGCCGATAGC -> CGCCGATAGCA
GCGCCTTGCAG -> CGCCTTGCAGT
GCGCGCACCGC -> CGCGCACCGCA
GCGCGGTATTA -> CGCGGTATTAG
GCGCGGTTAAG -> CGCGGTTAAGC
GCGCTCCATAA -> CGCTCCATAAA
GCGCTTGTAGG -> CGCTTGTAGGA
GCGCTTGTCTT -> CGCTTGTCTTC
GCGGAGGGCGC -> CGGAGGGCGCA
GCGGATCGATT -> CGGATCGATTT
GCGGATGCAGG -> CGGATGCAGGG
GCGGCGGTGCG -> CGGCGGTGCGC
GCGGGAATCCA -> CGGGAATCCAT
GCGGGGTGGCG -> CGGGGTGGCGG
GCGGGTCCTTG -> CGGGTCCTTGG
GCGGGTTGGCA -> CGGGTTGGCAG
GCGGTATTAGT -> CGGTATTAGTA
GCGGTGAACTT -> CGGTGAACTTT
GCGGTGCGCCG -> CGGTGCGCCGA
GCGGTTAACTT -> CGGTTAACTTC
GCGGTTAAGCA -> CGGTTAAGCAT
GCGGTTCATAA -> CGGTTCATAAT
GCGGTTGGTGA -> CGGTTGGTGAG
GCGTACATACG -> CGTACATACGA
GCGTCCAAGTG -> CGTCCAAGTGA
GCGTCCCGTCT -> CGTCCCGTCTA
GCGTGAGGGGC -> CGTGAGGGGCG
GCGTGCGAGTC -> CGTGCGAGTCG
GCGTGCGTGAG -> CGTGCGTGAGG
GCGTGCGTTTG -> CGTGCGTTTGT
GCGTGGGTCGT -> CGTGGGTCGTG
GCGTGTACGAG -> CGTGTACGAGT
GCGTTTGTTGC -> CGTTTGTTGCG
GCTAAAGAGTC -> CTAAAGAGTCC
GCTAAATTATA -> CTAAATTATAA
GCTAACTGAAA -> CTAACTGAAAC
GCTAGTACAGA -> CTAGTACAGAG
GCTATATCACT -> CTATATCACTG
GCTATCCTAAT -> CTATCCTAATA
GCTCATAGTCA -> CTCATAGTCAA
GCTCCGCTCAT -> CTCCGCTCATA
GCTCGCGACAA -> CTCGCGACAAT
GCTGAAGCAAC -> CTGAAGCAACA
GCTGATTTGTA -> CTGATTTGTAA
GCTGCCCGCTA -> CTGCCCGCTAG
GCTGGATAATT -> CTGGATAATTC
GCTGGCGGTTG -> CTGGCGGTTGG
GCTTCAATCCG -> CTTCAATCCGT
GCTTCGAGACA -> CTTCGAGACAG
GCTTGTAGGAC -> CTTGTAGGACA
GCTTGTCTTCG -> CTTGTCTTCGA
GCTTGTGTCCT -> CTTGTGTCCTA
GCTTTCGGGGT -> CTTTCGGGGTA
GCTTTGAGCTA -> CTTTGAGCTAA
GCTTTGGTGAC -> CTTTGGTGACA
GGAAACTCCGG -> GAAACTCCGGG
GGAAACTCTTC -> GAAACTCTTCA
GGAACCATTGT -> GAACCATTGTG
GGAAGCCCCCT -> GAAGCCCCCTC
GGAATCCATGT -> GAATCCATGTG
GGACAAAATGA -> GACAAAATGAT
GGACAAGCGGG -> GACAAGCGGGG
GGACATGGCGT -> GACATGGCGTG
GGACCAAACTG -> GACCAAACTGT
GGACCCTAAGA -> GACCCTAAGAA
GGACGCCTACA -> GACGCCTACAC
GGACGGGTGGT -> GACGGGTGGTA
GGACTTATCGT -> GACTTATCGTC
GGAGAAGGCGT -> GAGAAGGCGTG
GGAGAGCTTCG -> GAGAGCTTCGA
GGAGCGATAAG -> GAGCGATAAGA
GGAGGGACCCT -> GAGGGACCCTA
GGAGGGAGAAG -> GAGGGAGAAGG
GGAGGGCGCAC -> GAGGGCGCACT
GGATAATTCGC -> GATAATTCGCT
GGATACGACCC -> GATACGACCCC
GGATACGGCTT -> GATACGGCTTT
GGATATTTCAA -> GATATTTCAAT
GGATATTTCAG -> GATATTTCAGG
GGATCGATTTT -> GATCGATTTTC
GGATGCAGGGG -> GATGCAGGGGT
GGATGCGGTTA -> GATGCGGTTAA
GGATGGAGGGA -> GATGGAGGGAC
GGATGTTCGTT -> GATGTTCGTTG
GGATTAGACAT -> GATTAGACATA
GGCACGGACAT -> GCACGGACATG
GGCAGTAATTC -> GCAGTAATTCA
GGCATCGTGCA -> GCATCGTGCAG
GGCCACTCGTA -> GCCACTCGTAA
GGCCCGTCACC -> GCCCGTCACCG
GGCCGAGCCGG -> GCCGAGCCGGT
GGCCGTCAGTC -> GCCGTCAGTCT
GGCGATAAGCG -> GCGATAAGCGA
GGCGCACTGTT -> GCGCACTGTTT
GGCGCCTTGCA -> GCGCCTTGCAG
GGCGCTTGTAG -> GCGCTTGTAGG
GGCGGGAATCC -> GCGGGAATCCA
GGCGGGTCCTT -> GCGGGTCCTTG
GGCGGTGCGCC -> GCGGTGCGCCG
GGCGGTTCATA -> GCGGTTCATAA
GGCGGTTGGTG -> GCGGTTGGTGA
GGCGTGCGTGA -> GCGTGCGTGAG
GGCGTGTACGA -> GCGTGTACGAG
GGCTATATCAC -> GCTATATCACT
GGCTGATTTGT -> GCTGATTTGTA
GGCTGCCCGCT -> GCTGCCCGCTA
GGCTTGTGTCC -> GCTTGTGTCCT
GGCTTTCGGGG -> GCTTTCGGGGT
GGCTTTGGTGA -> GCTTTGGTGAC
GGGAATCCATG -> GGAATCCATGT
GGGACAAGCGG -> GGACAAGCGGG
GGGACCCTAAG -> GGACCCTAAGA
GGGACGCCTAC -> GGACGCCTACA
GGGACGGGTGG -> GGACGGGTGGT
GGGACTTATCG -> GGACTTATCGT
GGGAGAAGGCG -> GGAGAAGGCGT
GGGATACGGCT -> GGATACGGCTT
GGGCACGGACA -> GGCACGGACAT
GGGCGATAAGC -> GGCGATAAGCG
GGGCGCACTGT -> GGCGCACTGTT
GGGCGGTTCAT -> GGCGGTTCATA
GGGCTTGTGTC -> GGCTTGTGTCC
GGGCTTTCGGG -> GGCTTTCGGGG
GGGGACGGGTG -> GGGACGGGTGG
GGGGCGGTTCA -> GGGCGGTTCAT
GGGGCTTGTGT -> GGGCTTGTGTC
GGGGGCTTGTG -> GGGGCTTGTGT
GGGGGTCGTAA -> GGGGTCGTAAG
GGGGTATGCGG -> GGGTATGCGGC
GGGGTCCTCCA -> GGGTCCTCCAT
GGGGTCGTAAG -> GGGTCGTAAGG
GGGGTGGCGGG -> GGGTGGCGGGT
GGGTAGAACGG -> GGTAGAACGGT
GGGTATGCGGC -> GGTATGCGGCG
GGGTCCTCCAT -> GGTCCTCCATG
GGGTCCTTGGC -> GGTCCTTGGCG
GGGTCGTAAGG -> GGTCGTAAGGA
GGGTCGTGTGT -> GGTCGTGTGTT
GGGTGGCGGGT -> GGTGGCGGGTC
GGGTGGTAAGG -> GGTGGTAAGGA
GGGTTGGCAGT -> GGTTGGCAGTA
GGTAAAAGAAA -> GTAAAAGAAAC
GGTAAAGAGAG -> GTAAAGAGAGG
GGTAAATAGTC -> GTAAATAGTCC
GGTAACACTAC -> GTAACACTACA
GGTAAGGATGG -> GTAAGGATGGA
GGTACCGCGTC -> GTACCGCGTCC
GGTACGGCGCT -> GTACGGCGCTT
GGTAGAACGGT -> GTAGAACGGTA
GGTAGTCGCCG -> GTAGTCGCCGA
GGTAGTTCAAA -> GTAGTTCAAAA
GGTATGCGGCG -> GTATGCGGCGG
GGTATTAGTAA -> GTATTAGTAAA
GGTATTGAAGC -> GTATTGAAGCC
GGTATTTGTAA -> GTATTTGTAAT
GGTATTTTCAC -> GTATTTTCACC
GGTCCCCGATT -> GTCCCCGATTT
GGTCCTCCATG -> GTCCTCCATGG
GGTCCTTGGCG -> GTCCTTGGCGG
GGTCGAGCTAA -> GTCGAGCTAAA
GGTCGATATTG -> GTCGATATTGG
GGTCGTAAGGA -> GTCGTAAGGAG
GGTCGTGTGTT -> GTCGTGTGTTC
GGTCGTTTCCC -> GTCGTTTCCCA
GGTGAACTTTG -> GTGAACTTTGG
GGTGACATCTC -> GTGACATCTCT
GGTGAGAATTT -> GTGAGAATTTA
GGTGCGCCGAT -> GTGCGCCGATA
GGTGGCGGGTC -> GTGGCGGGTCC
GGTGGTAACAC -> GTGGTAACACT
GGTGGTAAGGA -> GTGGTAAGGAT
GGTTAACGAGG -> GTTAACGAGGT
GGTTAACTTCA -> GTTAACTTCAC
GGTTAAGCATG -> GTTAAGCATGC
GGTTCATAATG -> GTTCATAATGC
GGTTGAGGATT -> GTTGAGGATTA
GGTTGGCAGTA -> GTTGGCAGTAA
GGTTGGTGAGA -> GTTGGTGAGAA
GGTTTAAGCGC -> GTTTAAGCGCG
GGTTTTTACGA -> GTTTTTACGAG
GTAAAAAAAGA -> TAAAAAAAGAG
GTAAAAAGTCG -> TAAAAAGTCGA
GTAAAAGAAAC -> TAAAAGAAACC
GTAAAGAGAGG -> TAAAGAGAGGG
GTAAAGGCGCC -> TAAAGGCGCCT
GTAAATAGTCC -> TAAATAGTCCT
GTAAATCGGTA -> TAAATCGGTAA
GTAACACTACA -> TAACACTACAA
GTAAGAAAATG -> TAAGAAAATGA
GTAAGGAGGGA -> TAAGGAGGGAG
GTAAGGATGGA -> TAAGGATGGAG
GTAATGGATAT -> TAATGGATATT
GTAATTCAAAC -> TAATTCAAACC
GTAATTCCATT -> TAATTCCATTG
GTACACCATTT -> TACACCATTTA
GTACACCTAAA -> TACACCTAAAC
GTACAGAGCTA -> TACAGAGCTAT
GTACATACGAA -> TACATACGAAT
GTACCGACCGC -> TACCGACCGCC
GTACCGCGTCC -> TACCGCGTCCA
GTACCTATGTG -> TACCTATGTGA
GTACGAGTACC -> TACGAGTACCG
GTACGGCGCTT -> TACGGCGCTTG
GTACTACGAGT -> TACTACGAGTG
GTACTTAAACC -> TACTTAAACCC
GTACTTCTGCT -> TACTTCTGCTG
GTAGAACGGTA -> TAGAACGGTAT
GTAGGACAAAA -> TAGGACAAAAT
GTAGTCGCCGA -> TAGTCGCCGAC
GTAGTTCAAAA -> TAGTTCAAAAG
GTAGTTTCCTC -> TAGTTTCCTCA
GTATACCTATT -> TATACCTATTG
GTATGCGGCGG -> TATGCGGCGGT
GTATTAGTAAA -> TATTAGTAAAT
GTATTGAAGCC -> TATTGAAGCCC
GTATTTGTAAT -> TATTTGTAATG
GTATTTTCACC -> TATTTTCACCG
GTCAACGATAA -> TCAACGATAAG
GTCACAGGAGA -> TCACAGGAGAG
GTCACCCGATC -> TCACCCGATCG
GTCACCGGATG -> TCACCGGATGT
GTCACTTCCGA -> TCACTTCCGAT
GTCAGTCTATT -> TCAGTCTATTG
GTCCAAGTGAC -> TCCAAGTGACC
GTCCACGACAG -> TCCACGACAGA
GTCCCCGATTT -> TCCCCGATTTT
GTCCCGTCTAG -> TCCCGTCTAGT
GTCCGTTAGGA -> TCCGTTAGGAC
GTCCTATTTCC -> TCCTATTTCCG
GTCCTCCATGG -> TCCTCCATGGG
GTCCTCCGCTG -> TCCTCCGCTGG
GTCCTTATCAT -> TCCTTATCATG
GTCCTTGGCGG -> TCCTTGGCGGG
GTCGACCTTGT -> TCGACCTTGTC
GTCGACGTGAT -> TCGACGTGATG
GTCGAGCTAAA -> TCGAGCTAAAT
GTCGATATTGG -> TCGATATTGGA
GTCGATCGTTC -> TCGATCGTTCT
GTCGCAATTAG -> TCGCAATTAGA
GTCGCCGACTA -> TCGCCGACTAT
GTCGGTATTTG -> TCGGTATTTGT
GTCGTAAGGAG -> TCGTAAGGAGG
GTCGTACACCA -> TCGTACACCAT
GTCGTGTGTTC -> TCGTGTGTTCA
GTCGTTTCCCA -> TCGTTTCCCAG
GTCTAGTTCGA -> TCTAGTTCGAT
GTCTATTGGGC -> TCTATTGGGCG
GTCTCCTGCGC -> TCTCCTGCGCT
GTCTTCGATAA -> TCTTCGATAAC
GTCTTGCAGTT -> TCTTGCAGTTA
GTGAACATGGT -> TGAACATGGTC
GTGAACTTTGG -> TGAACTTTGGA
GTGAATACATC -> TGAATACATCA
GTGAATATGAT -> TGAATATGATG
GTGACATCTCT -> TGACATCTCTA
GTGACCGATGT -> TGACCGATGTG
GTGACTGGGCA -> TGACTGGGCAC
GTGAGAATTTA -> TGAGAATTTAG
GTGAGATTACA -> TGAGATTACAA
GTGAGCAGTAT -> TGAGCAGTATA
GTGAGCTCGCG -> TGAGCTCGCGA
GTGAGGGGCGG -> TGAGGGGCGGT
GTGATGTACTT -> TGATGTACTTA
GTGCAGATATT -> TGCAGATATTC
GTGCATAAAAG -> TGCATAAAAGC
GTGCCCCACAC -> TGCCCCACACA
GTGCGAGTCGA -> TGCGAGTCGAC
GTGCGCCGATA -> TGCGCCGATAG
GTGCGTGAGGG -> TGCGTGAGGGG
GTGCGTTTGTT -> TGCGTTTGTTG
GTGGAGCGATA -> TGGAGCGATAA
GTGGATACGAC -> TGGATACGACC
GTGGCGGGTCC -> TGGCGGGTCCT
GTGGGCTTTCG -> TGGGCTTTCGG
GTGGGTCGTGT -> TGGGTCGTGTG
GTGGTAACACT -> TGGTAACACTA
GTGGTAAGGAT -> TGGTAAGGATG
GTGGTACCGCG -> TGGTACCGCGT
GTGGTAGTTCA -> TGGTAGTTCAA
GTGGTTTTTAC -> TGGTTTTTACG
GTGTACGAGTA -> TGTACGAGTAC
GTGTCACAGGA -> TGTCACAGGAG
GTGTCCTATTT -> TGTCCTATTTC
GTGTGGTTTTT -> TGTGGTTTTTA
GTGTGTTCACA -> TGTGTTCACAA
GTGTTCACAAA -> TGTTCACAAAC
GTTAACGAGGT -> TTAACGAGGTA
GTTAACGATTG -> TTAACGATTGA
GTTAACTTCAC -> TTAACTTCACT
GTTAACTTTGC -> TTAACTTTGCT
GTTAAGCATGC -> TTAAGCATGCG
GTTAGAATGCG -> TTAGAATGCGC
GTTAGGACCAA -> TTAGGACCAAA
GTTATCACCTT -> TTATCACCTTC
GTTCAAAAGTG -> TTCAAAAGTGC
GTTCACAAACC -> TTCACAAACCC
GTTCATAATGC -> TTCATAATGCA
GTTCGATATGC -> TTCGATATGCA
GTTCGTTGTCT -> TTCGTTGTCTT
GTTCTCAAGTG -> TTCTCAAGTGG
GTTCTTTTTCG -> TTCTTTTTCGG
GTTGAGGATTA -> TTGAGGATTAG
GTTGCGTACAT -> TTGCGTACATA
GTTGCTTCAAT -> TTGCTTCAATC
GTTGGAACCAT -> TTGGAACCATT
GTTGGCAGTAA -> TTGGCAGTAAT
GTTGGTGAGAA -> TTGGTGAGAAT
GTTGTCTTGCA -> TTGTCTTGCAG
GTTTAAGCGCG -> TTTAAGCGCGC
GTTTCCCAGAC -> TTTCCCAGACC
GTTTCCTCAAG -> TTTCCTCAAGG
GTTTGGGACAA -> TTTGGGACAAG
GTTTGTTGCGT -> TTTGTTGCGTA
GTTTTAGGAAG -> TTTTAGGAAGC
GTTTTTACGAG -> TTTTTACGAGC
TAAAAAAAGAG -> AAAAAAAGAGG
TAAAAAGTCGA -> AAAAAGTCGAT
TAAAAGAAACC -> AAAAGAAACCC
TAAAAGCGCGG -> AAAAGCGCGGT
TAAACCATCAC -> AAACCATCACT
TAAACCCTAGG -> AAACCCTAGGT
TAAACCGGCCA -> AAACCGGCCAC
TAAAGAAGTTT -> AAAGAAGTTTG
TAAAGAGAGGG -> AAAGAGAGGGT
TAAAGAGTCCG -> AAAGAGTCCGT
TAAAGGCGCCT -> AAAGGCGCCTT
TAAATAGTCCT -> AAATAGTCCTT
TAAATCGGTAA -> AAATCGGTAAA
TAAATTATAAC -> AAATTATAACA
TAACACTACAA -> AACACTACAAC
TAACATCCCTG -> AACATCCCTGT
TAACGAGGTAC -> AACGAGGTACG
TAACGATTGAG -> AACGATTGAGC
TAACGCGTCCC -> AACGCGTCCCG
TAACTGAAACA -> AACTGAAACAT
TAACTGATCTT -> AACTGATCTTT
TAACTTCACTA -> AACTTCACTAG
TAACTTTGCTA -> AACTTTGCTAA
TAAGAAAATGA -> AAGAAAATGAG
TAAGAATCGTT -> AAGAATCGTTG
TAAGAGGCTAT -> AAGAGGCTATA
TAAGCAGGCCG -> AAGCAGGCCGA
TAAGCATGCGG -> AAGCATGCGGA
TAAGCGATGGC -> AAGCGATGGCT
TAAGCGCGCAC -> AAGCGCGCACC
TAAGCTTTGAG -> AAGCTTTGAGC
TAAGGAGGGAG -> AAGGAGGGAGA
TAAGGATGGAG -> AAGGATGGAGG
TAATACTGCGG -> AATACTGCGGG
TAATGCAAGTT -> AATGCAAGTTA
TAATGGATATT -> AATGGATATTT
TAATGTGAATA -> AATGTGAATAT
TAATTCAAACC -> AATTCAAACCG
TAATTCCATTG -> AATTCCATTGA
TAATTCGCTGA -> AATTCGCTGAA
TACAACAGAAA -> ACAACAGAAAC
TACAACGATCT -> ACAACGATCTA
TACAACTGTGC -> ACAACTGTGCA
TACACCATTTA -> ACACCATTTAG
TACACCTAAAC -> ACACCTAAACC
TACACTTTTAG -> ACACTTTTAGT
TACAGAGCTAT -> ACAGAGCTATC
TACATACGAAT -> ACATACGAATC
TACATCACCCT -> ACATCACCCTT
TACATGATAAA -> ACATGATAAAC
TACCGACCGCC -> ACCGACCGCCC
TACCGCGTCCA -> ACCGCGTCCAA
TACCTATGTGA -> ACCTATGTGAA
TACCTATTGAC -> ACCTATTGACG
TACGAATCTTA -> ACGAATCTTAC
TACGACCCCTC -> ACGACCCCTCA
TACGAGCGATA -> ACGAGCGATAG
TACGAGTACCG -> ACGAGTACCGA
TACGAGTGAGC -> ACGAGTGAGCA
TACGGCGCTTG -> ACGGCGCTTGT
TACGGCTTTGG -> ACGGCTTTGGT
TACGTGAGATT -> ACGTGAGATTA
TACTACGAGTG -> ACTACGAGTGA
TACTCCTGTTA -> ACTCCTGTTAA
TACTGCGGGTT -> ACTGCGGGTTG
TACTGCGTGCG -> ACTGCGTGCGA
TACTTAAACCC -> ACTTAAACCCT
TACTTCTGCTG -> ACTTCTGCTGG
TAGAACGGTAT -> AGAACGGTATT
TAGAATGCGCA -> AGAATGCGCAG
TAGACAACCTT -> AGACAACCTTA
TAGACAGATTC -> AGACAGATTCT
TAGACATATGG -> AGACATATGGT
TAGATTCTTAC -> AGATTCTTACA
TAGCAGTCACC -> AGCAGTCACCC
TAGGAAGCCCC -> AGGAAGCCCCC
TAGGACAAAAT -> AGGACAAAATG
TAGGACCAAAC -> AGGACCAAACT
TAGGGACGCCT -> AGGGACGCCTA
TAGGGATACGG -> AGGGATACGGC
TAGGTGGTAAC -> AGGTGGTAACA
TAGGTTGAGGA -> AGGTTGAGGAT
TAGTAAATCGG -> AGTAAATCGGT
TAGTAATTCCA -> AGTAATTCCAT
TAGTACAGAGC -> AGTACAGAGCT
TAGTCAACGAT -> AGTCAACGATA
TAGTCCTTATC -> AGTCCTTATCA
TAGTCGCCGAC -> AGTCGCCGACT
TAGTCGTACAC -> AGTCGTACACC
TAGTGGAGCGA -> AGTGGAGCGAT
TAGTTCAAAAG -> AGTTCAAAAGT
TAGTTCGATAT -> AGTTCGATATG
TAGTTCTTTTT -> AGTTCTTTTTC
TAGTTTCCTCA -> AGTTTCCTCAA
TATAACATCCC -> ATAACATCCCT
TATACCTATTG -> ATACCTATTGA
TATATCACTGA -> ATATCACTGAT
TATCACCTTCC -> ATCACCTTCCA
TATCACTGATC -> ATCACTGATCT
TATCAGTCCTC -> ATCAGTCCTCC
TATCATGGCAT -> ATCATGGCATC
TATCCTAATAC -> ATCCTAATACT
TATCGTCGGTA -> ATCGTCGGTAT
TATGATCAAAC -> ATGATCAAACC
TATGATGATCG -> ATGATGATCGT
TATGCAGCGAA -> ATGCAGCGAAA
TATGCGGCGGT -> ATGCGGCGGTG
TATGCTCCGCT -> ATGCTCCGCTC
TATGGTAAAGA -> ATGGTAAAGAG
TATGTGAACAT -> ATGTGAACATG
TATTAGTAAAT -> ATTAGTAAATC
TATTCACGACC -> ATTCACGACCC
TATTCACTGCA -> ATTCACTGCAT
TATTCTTGCGG -> ATTCTTGCGGT
TATTGAAGCCC -> ATTGAAGCCCT
TATTGACGTGT -> ATTGACGTGTG
TATTGGAAACT -> ATTGGAAACTC
TATTGGGCGAT -> ATTGGGCGATA
TATTTAGTTCT -> ATTTAGTTCTT
TATTTCAATAG -> ATTTCAATAGG
TATTTCAGGTA -> ATTTCAGGTAA
TATTTCCGCGC -> ATTTCCGCGCG
TATTTGTAATG -> ATTTGTAATGG
TATTTTCACCG -> ATTTTCACCGA
TCAAAAGTGCC -> CAAAAGTGCCC
TCAAACCCAGC -> CAAACCCAGCA
TCAAACCGAAC -> CAAACCGAACA
TCAACGATAAG -> CAACGATAAGC
TCAAGGCCGTC -> CAAGGCCGTCA
TCAAGTGGGCT -> CAAGTGGGCTT
TCAATACTCCT -> CAATACTCCTG
TCAATAGGGAC -> CAATAGGGACG
TCAATCCGTGG -> CAATCCGTGGT
TCACAAACCCC -> CACAAACCCCT
TCACAGGAGAG -> CACAGGAGAGC
TCACCCGATCG -> CACCCGATCGG
TCACCCTTGAA -> CACCCTTGAAC
TCACCGAGTTG -> CACCGAGTTGG
TCACCGGATGT -> CACCGGATGTT
TCACCTACATG -> CACCTACATGA
TCACCTTCCAT -> CACCTTCCATG
TCACGACCCTT -> CACGACCCTTG
TCACTAGTAAT -> CACTAGTAATT
TCACTGATCTT -> CACTGATCTTT
TCACTGCATCA -> CACTGCATCAT
TCACTTCCGAT -> CACTTCCGATG
TCACTTGGTCG -> CACTTGGTCGA
TCAGCCTGACA -> CAGCCTGACAT
TCAGGTAAATA -> CAGGTAAATAG
TCAGTCCTCCG -> CAGTCCTCCGC
TCAGTCTATTG -> CAGTCTATTGG
TCATAATGCAA -> CATAATGCAAG
TCATAGTCAAC -> CATAGTCAACG
TCATGGCATCG -> CATGGCATCGT
TCATGGTCGAG -> CATGGTCGAGC
TCATGTACTAC -> CATGTACTACG
TCATTATTTAG -> CATTATTTAGT
TCCAAAATCGG -> CCAAAATCGGC
TCCAAGTGACC -> CCAAGTGACCG
TCCACGACAGA -> CCACGACAGAA
TCCATGCGCCA -> CCATGCGCCAC
TCCATGGGGGC -> CCATGGGGGCT
TCCATGTGAAT -> CCATGTGAATA
TCCATTGACCA -> CCATTGACCAG
TCCCAGACCAG -> CCCAGACCAGA
TCCCCGATTTT -> CCCCGATTTTC
TCCCCTGATTC -> CCCCTGATTCC
TCCCGTCTAGT -> CCCGTCTAGTT
TCCCTGTGACT -> CCCTGTGACTG
TCCGATGCGGA -> CCGATGCGGAT
TCCGCGCGGTA -> CCGCGCGGTAT
TCCGCTCATAG -> CCGCTCATAGT
TCCGCTGGCGG -> CCGCTGGCGGT
TCCGGGGACGG -> CCGGGGACGGG
TCCGTGGTACC -> CCGTGGTACCG
TCCGTTAGGAC -> CCGTTAGGACC
TCCTAAAGAAG -> CCTAAAGAAGT
TCCTAATACTG -> CCTAATACTGC
TCCTATTTCCG -> CCTATTTCCGC
TCCTCAAGGCC -> CCTCAAGGCCG
TCCTCCATGGG -> CCTCCATGGGG
TCCTCCGCTGG -> CCTCCGCTGGC
TCCTGCGCTCC -> CCTGCGCTCCA
TCCTGTTAACG -> CCTGTTAACGA
TCCTTATCATG -> CCTTATCATGG
TCCTTGGCGGG -> CCTTGGCGGGA
TCGACCAAGCA -> CGACCAAGCAG
TCGACCTTGTC -> CGACCTTGTCC
TCGACGTGATG -> CGACGTGATGT
TCGAGACAGAT -> CGAGACAGATG
TCGAGCTAAAT -> CGAGCTAAATT
TCGAGTCTCCT -> CGAGTCTCCTG
TCGATAACTGA -> CGATAACTGAT
TCGATATGCAG -> CGATATGCAGC
TCGATATTGGA -> CGATATTGGAA
TCGATCGTTCT -> CGATCGTTCTC
TCGATTTTCGA -> CGATTTTCGAC
TCGCAATTAGA -> CGCAATTAGAC
TCGCACTCGCC -> CGCACTCGCCT
TCGCCGACTAT -> CGCCGACTATT
TCGCCTATCAG -> CGCCTATCAGT
TCGCCTCGCCT -> CGCCTCGCCTA
TCGCGACAATC -> CGCGACAATCG
TCGCGGAGGGC -> CGCGGAGGGCG
TCGCTGAAGCA -> CGCTGAAGCAA
TCGGCTGATTT -> CGGCTGATTTG
TCGGGGGTCGT -> CGGGGGTCGTA
TCGGGGTATGC -> CGGGGTATGCG
TCGGTAAAAGA -> CGGTAAAAGAA
TCGGTATTGAA -> CGGTATTGAAG
TCGGTATTTGT -> CGGTATTTGTA
TCGTAAGAAAA -> CGTAAGAAAAT
TCGTAAGGAGG -> CGTAAGGAGGG
TCGTACACCAT -> CGTACACCATT
TCGTCGCAATT -> CGTCGCAATTA
TCGTCGGTATT -> CGTCGGTATTT
TCGTGCAGATA -> CGTGCAGATAT
TCGTGTGTTCA -> CGTGTGTTCAC
TCGTTCTCAAG -> CGTTCTCAAGT
TCGTTGCTTCA -> CGTTGCTTCAA
TCGTTGTCTTG -> CGTTGTCTTGC
TCGTTTCCCAG -> CGTTTCCCAGA
TCTACTGCGTG -> CTACTGCGTGC
TCTAGTTCGAT -> CTAGTTCGATA
TCTATGATCAA -> CTATGATCAAA
TCTATGCTCCG -> CTATGCTCCGC
TCTATTGGGCG -> CTATTGGGCGA
TCTCAAGTGGG -> CTCAAGTGGGC
TCTCCTGCGCT -> CTCCTGCGCTC
TCTCTACTGCG -> CTCTACTGCGT
TCTCTATGCTC -> CTCTATGCTCC
TCTGCCGAAGT -> CTGCCGAAGTA
TCTGCGCTTGT -> CTGCGCTTGTC
TCTGCTGGATA -> CTGCTGGATAA
TCTTACAACAG -> CTTACAACAGA
TCTTACGTGAG -> CTTACGTGAGA
TCTTCATGGTC -> CTTCATGGTCG
TCTTCGATAAC -> CTTCGATAACT
TCTTGCAGTTA -> CTTGCAGTTAG
TCTTGCGGTGA -> CTTGCGGTGAA
TCTTTAAGCTT -> CTTTAAGCTTT
TCTTTTCTGCC -> CTTTTCTGCCG
TCTTTTTCGGG -> CTTTTTCGGGG
TGAAACATATT -> GAAACATATTC
TGAACATGGTC -> GAACATGGTCC
TGAACCGCCTC -> GAACCGCCTCG
TGAACTTTGGA -> GAACTTTGGAT
TGAAGCAACAG -> GAAGCAACAGG
TGAAGCCCTAA -> GAAGCCCTAAT
TGAATACATCA -> GAATACATCAC
TGAATATGATG -> GAATATGATGA
TGACATCGCAC -> GACATCGCACT
TGACATCTCTA -> GACATCTCTAT
TGACCAGGGAC -> GACCAGGGACT
TGACCGATGTG -> GACCGATGTGG
TGACGTGTGGT -> GACGTGTGGTT
TGACTGGGCAC -> GACTGGGCACG
TGAGAATTTAG -> GAGAATTTAGT
TGAGATGTACC -> GAGATGTACCT
TGAGATTACAA -> GAGATTACAAC
TGAGCACGTAA -> GAGCACGTAAA
TGAGCAGTATA -> GAGCAGTATAC
TGAGCTAACTG -> GAGCTAACTGA
TGAGCTCGCGA -> GAGCTCGCGAC
TGAGGATTAGA -> GAGGATTAGAC
TGAGGGGCGGT -> GAGGGGCGGTT
TGATAAACCGG -> GATAAACCGGC
TGATCAAACCC -> GATCAAACCCA
TGATCGTCGCA -> GATCGTCGCAA
TGATCTTTAAG -> GATCTTTAAGC
TGATCTTTTCT -> GATCTTTTCTG
TGATGATCGTC -> GATGATCGTCG
TGATGTACTTA -> GATGTACTTAA
TGATTCAATAC -> GATTCAATACT
TGATTCCAAAA -> GATTCCAAAAT
TGATTTGTAAA -> GATTTGTAAAA
TGCAAGTTAAC -> GCAAGTTAACT
TGCAGATATTC -> GCAGATATTCA
TGCAGCGAAAG -> GCAGCGAAAGC
TGCAGGGGTCC -> GCAGGGGTCCT
TGCAGTACTTC -> GCAGTACTTCT
TGCAGTTAGAA -> GCAGTTAGAAT
TGCATAAAAGC -> GCATAAAAGCG
TGCATCATTAT -> GCATCATTATT
TGCCCCACACA -> GCCCCACACAA
TGCCCGCTAGT -> GCCCGCTAGTA
TGCCGAAGTAG -> GCCGAAGTAGT
TGCGAGTCGAC -> GCGAGTCGACC
TGCGCAGCGTG -> GCGCAGCGTGG
TGCGCCACACC -> GCGCCACACCG
TGCGCCGATAG -> GCGCCGATAGC
TGCGCTCCATA -> GCGCTCCATAA
TGCGCTTGTCT -> GCGCTTGTCTT
TGCGGATCGAT -> GCGGATCGATT
TGCGGATGCAG -> GCGGATGCAGG
TGCGGCGGTGC -> GCGGCGGTGCG
TGCGGGTTGGC -> GCGGGTTGGCA
TGCGGTGAACT -> GCGGTGAACTT
TGCGGTTAACT -> GCGGTTAACTT
TGCGTACATAC -> GCGTACATACG
TGCGTGAGGGG -> GCGTGAGGGGC
TGCGTGCGAGT -> GCGTGCGAGTC
TGCGTTTGTTG -> GCGTTTGTTGC
TGCTAAAGAGT -> GCTAAAGAGTC
TGCTCCGCTCA -> GCTCCGCTCAT
TGCTGGATAAT -> GCTGGATAATT
TGCTTCAATCC -> GCTTCAATCCG
TGGAAACTCTT -> GGAAACTCTTC
TGGAACCATTG -> GGAACCATTGT
TGGAGCGATAA -> GGAGCGATAAG
TGGAGGGACCC -> GGAGGGACCCT
TGGATAATTCG -> GGATAATTCGC
TGGATACGACC -> GGATACGACCC
TGGATATTTCA -> GGATATTTCAA,GGATATTTCAG
TGGCAGTAATT -> GGCAGTAATTC
TGGCATCGTGC -> GGCATCGTGCA
TGGCCCGTCAC -> GGCCCGTCACC
TGGCGGGAATC -> GGCGGGAATCC
TGGCGGGTCCT -> GGCGGGTCCTT
TGGCGGTTGGT -> GGCGGTTGGTG
TGGCGTGTACG -> GGCGTGTACGA
TGGCTGCCCGC -> GGCTGCCCGCT
TGGGACAAGCG -> GGGACAAGCGG
TGGGCACGGAC -> GGGCACGGACA
TGGGCGATAAG -> GGGCGATAAGC
TGGGCTTTCGG -> GGGCTTTCGGG
TGGGGGCTTGT -> GGGGGCTTGTG
TGGGTCGTGTG -> GGGTCGTGTGT
TGGTAAAGAGA -> GGTAAAGAGAG
TGGTAACACTA -> GGTAACACTAC
TGGTAAGGATG -> GGTAAGGATGG
TGGTACCGCGT -> GGTACCGCGTC
TGGTAGTTCAA -> GGTAGTTCAAA
TGGTCCCCGAT -> GGTCCCCGATT
TGGTCGAGCTA -> GGTCGAGCTAA
TGGTCGATATT -> GGTCGATATTG
TGGTGACATCT -> GGTGACATCTC
TGGTGAGAATT -> GGTGAGAATTT
TGGTTTTTACG -> GGTTTTTACGA
TGTAAAAAAAG -> GTAAAAAAAGA
TGTAATGGATA -> GTAATGGATAT
TGTACACCTAA -> GTACACCTAAA
TGTACCTATGT -> GTACCTATGTG
TGTACGAGTAC -> GTACGAGTACC
TGTACTACGAG -> GTACTACGAGT
TGTACTTAAAC -> GTACTTAAACC
TGTAGGACAAA -> GTAGGACAAAA
TGTCACAGGAG -> GTCACAGGAGA
TGTCACTTCCG -> GTCACTTCCGA
TGTCCACGACA -> GTCCACGACAG
TGTCCTATTTC -> GTCCTATTTCC
TGTCTTCGATA -> GTCTTCGATAA
TGTCTTGCAGT -> GTCTTGCAGTT
TGTGAACATGG -> GTGAACATGGT
TGTGAATACAT -> GTGAATACATC
TGTGAATATGA -> GTGAATATGAT
TGTGACTGGGC -> GTGACTGGGCA
TGTGAGCTCGC -> GTGAGCTCGCG
TGTGCATAAAA -> GTGCATAAAAG
TGTGGTAGTTC -> GTGGTAGTTCA
TGTGGTTTTTA -> GTGGTTTTTAC
TGTGTCCTATT -> GTGTCCTATTT
TGTGTTCACAA -> GTGTTCACAAA
TGTTAACGATT -> GTTAACGATTG
TGTTCACAAAC -> GTTCACAAACC
TGTTCGTTGTC -> GTTCGTTGTCT
TGTTGCGTACA -> GTTGCGTACAT
TGTTTTAGGAA -> GTTTTAGGAAG
TTAAACCCTAG -> TAAACCCTAGG
TTAACGAGGTA -> TAACGAGGTAC
TTAACGATTGA -> TAACGATTGAG
TTAACTTCACT -> TAACTTCACTA
TTAACTTTGCT -> TAACTTTGCTA
TTAAGCATGCG -> TAAGCATGCGG
TTAAGCGCGCA -> TAAGCGCGCAC
TTAAGCTTTGA -> TAAGCTTTGAG
TTACAACAGAA -> TACAACAGAAA
TTACAACGATC -> TACAACGATCT
TTACGAGCGAT -> TACGAGCGATA
TTACGTGAGAT -> TACGTGAGATT
TTAGAATGCGC -> TAGAATGCGCA
TTAGACAGATT -> TAGACAGATTC
TTAGACATATG -> TAGACATATGG
TTAGATTCTTA -> TAGATTCTTAC
TTAGGAAGCCC -> TAGGAAGCCCC
TTAGGACCAAA -> TAGGACCAAAC
TTAGGGATACG -> TAGGGATACGG
TTAGTAAATCG -> TAGTAAATCGG
TTAGTCGTACA -> TAGTCGTACAC
TTAGTGGAGCG -> TAGTGGAGCGA
TTAGTTCTTTT -> TAGTTCTTTTT
TTATAACATCC -> TATAACATCCC
TTATCACCTTC -> TATCACCTTCC
TTATCATGGCA -> TATCATGGCAT
TTATCGTCGGT -> TATCGTCGGTA
TTATTTAGTTC -> TATTTAGTTCT
TTCAAAAGTGC -> TCAAAAGTGCC
TTCAAACCGAA -> TCAAACCGAAC
TTCAATACTCC -> TCAATACTCCT
TTCAATAGGGA -> TCAATAGGGAC
TTCAATCCGTG -> TCAATCCGTGG
TTCACAAACCC -> TCACAAACCCC
TTCACCGAGTT -> TCACCGAGTTG
TTCACGACCCT -> TCACGACCCTT
TTCACTAGTAA -> TCACTAGTAAT
TTCACTGCATC -> TCACTGCATCA
TTCAGGTAAAT -> TCAGGTAAATA
TTCATAATGCA -> TCATAATGCAA
TTCATGGTCGA -> TCATGGTCGAG
TTCCAAAATCG -> TCCAAAATCGG
TTCCATGCGCC -> TCCATGCGCCA
TTCCATTGACC -> TCCATTGACCA
TTCCCAGACCA -> TCCCAGACCAG
TTCCCCTGATT -> TCCCCTGATTC
TTCCGATGCGG -> TCCGATGCGGA
TTCCGCGCGGT -> TCCGCGCGGTA
TTCCTCAAGGC -> TCCTCAAGGCC
TTCGACCAAGC -> TCGACCAAGCA
TTCGAGACAGA -> TCGAGACAGAT
TTCGATAACTG -> TCGATAACTGA
TTCGATATGCA -> TCGATATGCAG
TTCGCTGAAGC -> TCGCTGAAGCA
TTCGGGGGTCG -> TCGGGGGTCGT
TTCGGGGTATG -> TCGGGGTATGC
TTCGTTGTCTT -> TCGTTGTCTTG
TTCTCAAGTGG -> TCTCAAGTGGG
TTCTGCCGAAG -> TCTGCCGAAGT
TTCTGCGCTTG -> TCTGCGCTTGT
TTCTGCTGGAT -> TCTGCTGGATA
TTCTTACAACA -> TCTTACAACAG
TTCTTGCGGTG -> TCTTGCGGTGA
TTCTTTTTCGG -> TCTTTTTCGGG
TTGAACCGCCT -> TGAACCGCCTC
TTGAAGCCCTA -> TGAAGCCCTAA
TTGACCAGGGA -> TGACCAGGGAC
TTGACGTGTGG -> TGACGTGTGGT
TTGAGCACGTA -> TGAGCACGTAA
TTGAGCTAACT -> TGAGCTAACTG
TTGAGGATTAG -> TGAGGATTAGA
TTGCAGTACTT -> TGCAGTACTTC
TTGCAGTTAGA -> TGCAGTTAGAA
TTGCGGTGAAC -> TGCGGTGAACT
TTGCGTACATA -> TGCGTACATAC
TTGCTAAAGAG -> TGCTAAAGAGT
TTGCTTCAATC -> TGCTTCAATCC
TTGGAAACTCT -> TGGAAACTCTT
TTGGAACCATT -> TGGAACCATTG
TTGGATATTTC -> TGGATATTTCA
TTGGCAGTAAT -> TGGCAGTAATT
TTGGCGGGAAT -> TGGCGGGAATC
TTGGGACAAGC -> TGGGACAAGCG
TTGGGCGATAA -> TGGGCGATAAG
TTGGTCGATAT -> TGGTCGATATT
TTGGTGACATC -> TGGTGACATCT
TTGGTGAGAAT -> TGGTGAGAATT
TTGTAAAAAAA -> TGTAAAAAAAG
TTGTAATGGAT -> TGTAATGGATA
TTGTAGGACAA -> TGTAGGACAAA
TTGTCACTTCC -> TGTCACTTCCG
TTGTCCACGAC -> TGTCCACGACA
TTGTCTTCGAT -> TGTCTTCGATA
TTGTCTTGCAG -> TGTCTTGCAGT
TTGTGAGCTCG -> TGTGAGCTCGC
TTGTGTCCTAT -> TGTGTCCTATT
TTGTTGCGTAC -> TGTTGCGTACA
TTTAAGCGCGC -> TTAAGCGCGCA
TTTAAGCTTTG -> TTAAGCTTTGA
TTTACGAGCGA -> TTACGAGCGAT
TTTAGATTCTT -> TTAGATTCTTA
TTTAGGAAGCC -> TTAGGAAGCCC
TTTAGTCGTAC -> TTAGTCGTACA
TTTAGTGGAGC -> TTAGTGGAGCG
TTTAGTTCTTT -> TTAGTTCTTTT
TTTCAATAGGG -> TTCAATAGGGA
TTTCACCGAGT -> TTCACCGAGTT
TTTCAGGTAAA -> TTCAGGTAAAT
TTTCCCAGACC -> TTCCCAGACCA
TTTCCCCTGAT -> TTCCCCTGATT
TTTCCGCGCGG -> TTCCGCGCGGT
TTTCCTCAAGG -> TTCCTCAAGGC
TTTCGACCAAG -> TTCGACCAAGC
TTTCGGGGGTC -> TTCGGGGGTCG
TTTCGGGGTAT -> TTCGGGGTATG
TTTCTGCCGAA -> TTCTGCCGAAG
TTTGAGCTAAC -> TTGAGCTAACT
TTTGCTAAAGA -> TTGCTAAAGAG
TTTGGATATTT -> TTGGATATTTC
TTTGGGACAAG -> TTGGGACAAGC
TTTGGTGACAT -> TTGGTGACATC
TTTGTAAAAAA -> TTGTAAAAAAA
TTTGTAATGGA -> TTGTAATGGAT
TTTGTTGCGTA -> TTGTTGCGTAC
TTTTACGAGCG -> TTTACGAGCGA
TTTTAGGAAGC -> TTTAGGAAGCC
TTTTAGTCGTA -> TTTAGTCGTAC
TTTTCACCGAG -> TTTCACCGAGT
TTTTCCCCTGA -> TTTCCCCTGAT
TTTTCGACCAA -> TTTCGACCAAG
TTTTCGGGGGT -> TTTCGGGGGTC
TTTTCTGCCGA -> TTTCTGCCGAA
TTTTTACGAGC -> TTTTACGAGCG
TTTTTCGGGGG -> TTTTCGGGGGT
