AAAAATCGTAGGAATTCGC -> AAAATCGTAGGAATTCGCC
AAAACCAACCATCTTTAGG -> AAACCAACCATCTTTAGGT
AAAAGCCCGAAGACTGGGC -> AAAGCCCGAAGACTGGGCA
AAAATCAGCTTGTCACACT -> AAATCAGCTTGTCACACTC
AAAATCGACATGAGACTTA -> AAATCGACATGAGACTTAC
AAAATCGTAGGAATTCGCC -> AAATCGTAGGAATTCGCCC
AAAATCTCTAGAGGAGGTC -> AAATCTCTAGAGGAGGTCT
AAAATGCGGCGAAGTAGAC -> AAATGCGGCGAAGTAGACT
AAAATGCTAACGAGATCGC -> AAATGCTAACGAGATCGCC
AAACCAACCATCTTTAGGT -> AACCAACCATCTTTAGGTC
AAACCAGTCCACTTTATAG -> AACCAGTCCACTTTATAGT
AAACCTTCAGTCCCCGAAC -> AACCTTCAGTCCCCGAACC
AAACGAAGCAGTGGACAAA -> AACGAAGCAGTGGACAAAA
AAACGGTCCTAACCACAGG -> AACGGTCCTAACCACAGGC
AAACTGGATCGATGTCCTT -> AACTGGATCGATGTCCTTG
AAAGATGGTAACTTGGATC -> AAGATGGTAACTTGGATCA
AAAGCCCGAAGACTGGGCA -> AAGCCCGAAGACTGGGCAG
AAAGGACCACAGGCTGGGA -> AAGGACCACAGGCTGGGAG
AAAGGGCCGTCCTCCTTAC -> AAGGGCCGTCCTCCTTACC
AAAGGTGGGTAGAAACCAG -> AAGGTGGGTAGAAACCAGT
AAAGTCATGTGCTGGCTAT -> AAGTCATGTGCTGGCTATC
AAAGTGGTAAATTCAGCTG -> AAGTGGTAAATTCAGCTGT
AAATACGACTTTAGAGGAC -> AATACGACTTTAGAGGACA
AAATAGGTGAAACTGGATC -> AATAGGTGAAACTGGATCG
AAATATTGAATGACGCAAG -> AATATTGAATGACGCAAGA
AAATCAGCTTGTCACACTC -> AATCAGCTTGTCACACTCG
AAATCGACATGAGACTTAC -> AATCGACATGAGACTTACC
AAATCGGTATAGGTTAAGC -> AATCGGTATAGGTTAAGCC
AAATCGTAGGAATTCGCCC -> AATCGTAGGAATTCGCCCT
AAATCTCTAGAGGAGGTCT -> AATCTCTAGAGGAGGTCTA
AAATCTGCGAAGATTAGAG -> AATCTGCGAAGATTAGAGG
AAATCTGGGGTTATACAGG -> AATCTGGGGTTATACAGGT
AAATGCGGCGAAGTAGACT -> AATGCGGCGAAGTAGACTA
AAATGCTAACGAGATCGCC -> AATGCTAACGAGATCGCCA
AAATGTCTCAGCATGTGCA -> AATGTCTCAGCATGTGCAT
AAATGTGCGCAATTAGTAC -> AATGTGCGCAATTAGTACA
AAATTACCTATAATTTGGC -> AATTACCTATAATTTGGCC
AAATTCAGCTGTGGTGCGA -> AATTCAGCTGTGGTGCGAA
AACAGCAATCACAGGTGCA -> ACAGCAATCACAGGTGCAA
AACATGGTTATCTCTGACG -> ACATGGTTATCTCTGACGA
AACCAACCATCTTTAGGTC -> ACCAACCATCTTTAGGTCC
AACCACAGGCTCGGCTGCT -> ACCACAGGCTCGGCTGCTA
AACCAGTCCACTTTATAGT -> ACCAGTCCACTTTATAGTG
AACCATCTTTAGGTCCACC -> ACCATCTTTAGGTCCACCC
AACCCCTGCGTCGGTTTTA -> ACCCCTGCGTCGGTTTTAG
AACCCGACCTACGTGCGAG -> ACCCGACCTACGTGCGAGC
AACCTCGCATCTAGATATG -> ACCTCGCATCTAGATATGA
AACCTCTGATCTTCGATCT -> ACCTCTGATCTTCGATCTC
AACCTTCAGTCCCCGAACC -> ACCTTCAGTCCCCGAACCT
AACCTTGATATAGTAGATT -> ACCTTGATATAGTAGATTT
AACCTTTTAGTTATGCCGC -> ACCTTTTAGTTATGCCGCA
AACGAACTATTATGTTGGA -> ACGAACTATTATGTTGGAG
AACGAAGCAGTGGACAAAA -> ACGAAGCAGTGGACAAAAC
AACGACCAATTCGAATCTG -> ACGACCAATTCGAATCTGC
AACGAGATCGCCAGAGGTG -> ACGAGATCGCCAGAGGTGG
AACGGTCCTAACCACAGGC -> ACGGTCCTAACCACAGGCT
AACGTGCGGAGTTGGGGCA -> ACGTGCGGAGTTGGGGCAC
AACGTTTTATCGCGACGCA -> ACGTTTTATCGCGACGCAA
AACTAACGACCAATTCGAA -> ACTAACGACCAATTCGAAT
AACTATTATGTTGGAGTGG -> ACTATTATGTTGGAGTGGT
AACTATTATGTTGGAGTGT -> ACTATTATGTTGGAGTGTA,ACTATTATGTTGGAGTGTG
AACTATTATGTTGGAGTTA -> ACTATTATGTTGGAGTTAT
AACTCAGCTTTACCACACA -> ACTCAGCTTTACCACACAG
AACTCTTTGGTCCTTGAGG -> ACTCTTTGGTCCTTGAGGT
AACTGCTTGTCTACGTACC -> ACTGCTTGTCTACGTACCC
AACTGGAAATCGGTATAGG -> ACTGGAAATCGGTATAGGT
AACTGGATCGATGTCCTTG -> ACTGGATCGATGTCCTTGG
AACTGGTCGGGCGAACCCC -> ACTGGTCGGGCGAACCCCT
AACTTAGGCATATCTGCGT -> ACTTAGGCATATCTGCGTA
AACTTGGATCACTTGACAA -> ACTTGGATCACTTGACAAA
AAGACGATGAGCCGGCCCG -> AGACGATGAGCCGGCCCGC
AAGACTGGGCAGCACAAAT -> AGACTGGGCAGCACAAATT
AAGACTTCGTGAATCGAAC -> AGACTTCGTGAATCGAACT
AAGATGGTAACTTGGATCA -> AGATGGTAACTTGGATCAC
AAGATTAGAGGGACGCTAT -> AGATTAGAGGGACGCTATA
AAGATTGGACGAACTATTA -> AGATTGGACGAACTATTAT
AAGCACTACGGAGCAGTCA -> AGCACTACGGAGCAGTCAG
AAGCAGTGGACAAAACCAA -> AGCAGTGGACAAAACCAAC
AAGCCATCTGTACCCCAAA -> AGCCATCTGTACCCCAAAA
AAGCCCGAAGACTGGGCAG -> AGCCCGAAGACTGGGCAGC
AAGCCGCAATAGGGATGCG -> AGCCGCAATAGGGATGCGA
AAGCCGCGAACAGCAATCA -> AGCCGCGAACAGCAATCAC
AAGCCGTTCCTCGGACTAG -> AGCCGTTCCTCGGACTAGG
AAGCCTCGCGCAGCCATCT -> AGCCTCGCGCAGCCATCTA
AAGCGCATTCTACTACCTT -> AGCGCATTCTACTACCTTA
AAGCGGGGTGAGCGATCGT -> AGCGGGGTGAGCGATCGTC
AAGCGTCAGACCTTCGAAC -> AGCGTCAGACCTTCGAACT
AAGGACCACAGGCTGGGAG -> AGGACCACAGGCTGGGAGA
AAGGGCCGTCCTCCTTACC -> AGGGCCGTCCTCCTTACCT
AAGGGTTGACGGGGAGGTG -> AGGGTTGACGGGGAGGTGT
AAGGTAAGATTGGACGAAC -> AGGTAAGATTGGACGAACT
AAGGTGGGTAGAAACCAGT -> AGGTGGGTAGAAACCAGTC
AAGTAGACTAAACGAAGCA -> AGTAGACTAAACGAAGCAG
AAGTCATGTGCTGGCTATC -> AGTCATGTGCTGGCTATCT
AAGTCCGAAACCTTCAGTC -> AGTCCGAAACCTTCAGTCC
AAGTGGTAAATTCAGCTGT -> AGTGGTAAATTCAGCTGTG
AAGTGTCCGGAGACGTAGA -> AGTGTCCGGAGACGTAGAG
AAGTTACCCTATAACGAAC -> AGTTACCCTATAACGAACT
AAGTTCAAGCGGGGTGAGC -> AGTTCAAGCGGGGTGAGCG
AATAACATGGTTATCTCTG -> ATAACATGGTTATCTCTGA
AATAAGCGCATTCTACTAC -> ATAAGCGCATTCTACTACC
AATACGACTTTAGAGGACA -> ATACGACTTTAGAGGACAA
AATAGGGATGCGAAGGGTT -> ATAGGGATGCGAAGGGTTG
AATAGGTGAAACTGGATCG -> ATAGGTGAAACTGGATCGA
AATATTCTTCGGTTTACTA -> ATATTCTTCGGTTTACTAG
AATATTGAATGACGCAAGA -> ATATTGAATGACGCAAGAC
AATATTGATCTCCCTGCAG -> ATATTGATCTCCCTGCAGG
AATCAAAGATGGTAACTTG -> ATCAAAGATGGTAACTTGG
AATCACAGGTGCAATGTCG -> ATCACAGGTGCAATGTCGG
AATCACCAAAATCTCTAGA -> ATCACCAAAATCTCTAGAG
AATCAGCTTGTCACACTCG -> ATCAGCTTGTCACACTCGC
AATCCGTTTTGCGTTCTAT -> ATCCGTTTTGCGTTCTATG
AATCGAACTATTATGTTGG -> ATCGAACTATTATGTTGGA
AATCGACATGAGACTTACC -> ATCGACATGAGACTTACCC
AATCGGTATAGGTTAAGCC -> ATCGGTATAGGTTAAGCCT
AATCGTAGGAATTCGCCCT -> ATCGTAGGAATTCGCCCTT
AATCTCTAGAGGAGGTCTA -> ATCTCTAGAGGAGGTCTAC
AATCTGCGAAGATTAGAGG -> ATCTGCGAAGATTAGAGGG
AATCTGCTTTACCTTTTAT -> ATCTGCTTTACCTTTTATG
AATCTGGGGTTATACAGGT -> ATCTGGGGTTATACAGGTT
AATCTTTTACTGCCTCCCG -> ATCTTTTACTGCCTCCCGC
AATGACGCAAGACGATGAG -> ATGACGCAAGACGATGAGC
AATGCGGCGAAGTAGACTA -> ATGCGGCGAAGTAGACTAA
AATGCTAACGAGATCGCCA -> ATGCTAACGAGATCGCCAG
AATGCTGTGCTGGTAGGCG -> ATGCTGTGCTGGTAGGCGA
AATGGTACGCAGCGAAGCC -> ATGGTACGCAGCGAAGCCG
AATGTCGGCCCAGGCCCAG -> ATGTCGGCCCAGGCCCAGA
AATGTCTCAGCATGTGCAT -> ATGTCTCAGCATGTGCATA
AATGTGAACTAACGACCAA -> ATGTGAACTAACGACCAAT
AATGTGCGCAATTAGTACA -> ATGTGCGCAATTAGTACAG
AATGTGCGCCACAAGCCGT -> ATGTGCGCCACAAGCCGTT
AATTACCTATAATTTGGCC -> ATTACCTATAATTTGGCCT
AATTAGTACAGCGACTAAT -> ATTAGTACAGCGACTAATT
AATTATGGCTTGTCATTTC -> ATTATGGCTTGTCATTTCT
AATTCAGCTGTGGTGCGAA -> ATTCAGCTGTGGTGCGAAC
AATTCGAATCTGCTTTACC -> ATTCGAATCTGCTTTACCT
AATTCGCCCTTGCGACTGT -> ATTCGCCCTTGCGACTGTA
AATTCGGCCAAATATTGAA -> ATTCGGCCAAATATTGAAT
AATTGGTAGAGTAATGCTG -> ATTGGTAGAGTAATGCTGT
AATTTCCCGGAACTGGAAA -> ATTTCCCGGAACTGGAAAT
AATTTGGCCTTGCCAACTT -> ATTTGGCCTTGCCAACTTA
AATTTTAGGAAGACTTCGT -> ATTTTAGGAAGACTTCGTG
AATTTTAGGAAGCGTCAGA -> ATTTTAGGAAGCGTCAGAC
AATTTTAGGAAGGTAAGAT -> ATTTTAGGAAGGTAAGATT
AATTTTAGGAAGTTACCCT -> ATTTTAGGAAGTTACCCTA
ACAAAACCAACCATCTTTA -> CAAAACCAACCATCTTTAG
ACAAAGGACCACAGGCTGG -> CAAAGGACCACAGGCTGGG
ACAAATGTCTCAGCATGTG -> CAAATGTCTCAGCATGTGC
ACAAATTACCTATAATTTG -> CAAATTACCTATAATTTGG
ACAACCTTGATATAGTAGA -> CAACCTTGATATAGTAGAT
ACAAGCACTACGGAGCAGT -> CAAGCACTACGGAGCAGTC
ACAAGCCGTTCCTCGGACT -> CAAGCCGTTCCTCGGACTA
ACAATGGTACGCAGCGAAG -> CAATGGTACGCAGCGAAGC
ACAATTATGGCTTGTCATT -> CAATTATGGCTTGTCATTT
ACACAGGAAGCCATCTGTA -> CACAGGAAGCCATCTGTAC
ACACCAAAATGCTAACGAG -> CACCAAAATGCTAACGAGA
ACACTCGCATGATAAGTTC -> CACTCGCATGATAAGTTCA
ACAGCAATCACAGGTGCAA -> CAGCAATCACAGGTGCAAT
ACAGCGACTAATTTCCCGG -> CAGCGACTAATTTCCCGGA
ACAGGAAGCCATCTGTACC -> CAGGAAGCCATCTGTACCC
ACAGGCTCGGCTGCTAGAG -> CAGGCTCGGCTGCTAGAGG
ACAGGCTGGGAGACATTAT -> CAGGCTGGGAGACATTATC
ACAGGTGCAATGTCGGCCC -> CAGGTGCAATGTCGGCCCA
ACAGGTTCGAGCATATATG -> CAGGTTCGAGCATATATGA
ACATATCAGGTTAGCACCC -> CATATCAGGTTAGCACCCT
ACATGAGACTTACCCAATA -> CATGAGACTTACCCAATAT
ACATGGTCCGAGCTGGGAA -> CATGGTCCGAGCTGGGAAA
ACATGGTTATCTCTGACGA -> CATGGTTATCTCTGACGAA
ACATTAACGTTTTATCGCG -> CATTAACGTTTTATCGCGA
ACATTATCTTTTTGAAATC -> CATTATCTTTTTGAAATCT
ACATTCGTTGCAATTCGGC -> CATTCGTTGCAATTCGGCC
ACCAAAATCTCTAGAGGAG -> CCAAAATCTCTAGAGGAGG
ACCAAAATGCTAACGAGAT -> CCAAAATGCTAACGAGATC
ACCAACCATCTTTAGGTCC -> CCAACCATCTTTAGGTCCA
ACCAATTCGAATCTGCTTT -> CCAATTCGAATCTGCTTTA
ACCACACAGGAAGCCATCT -> CCACACAGGAAGCCATCTG
ACCACAGGCTCGGCTGCTA -> CCACAGGCTCGGCTGCTAG
ACCACAGGCTGGGAGACAT -> CCACAGGCTGGGAGACATT
ACCAGCGACAAAGGACCAC -> CCAGCGACAAAGGACCACA
ACCAGGTGAGCAGATCAAT -> CCAGGTGAGCAGATCAATA
ACCAGTCCACTTTATAGTG -> CCAGTCCACTTTATAGTGG
ACCAGTCGGGAGATCTATG -> CCAGTCGGGAGATCTATGA
ACCATCTTTAGGTCCACCC -> CCATCTTTAGGTCCACCCG
ACCCAATATTCTTCGGTTT -> CCCAATATTCTTCGGTTTA
ACCCACGTGATGACTTGGA -> CCCACGTGATGACTTGGAA
ACCCCAAAAGCCCGAAGAC -> CCCCAAAAGCCCGAAGACT
ACCCCTGCGTCGGTTTTAG -> CCCCTGCGTCGGTTTTAGG
ACCCCTGTACCTGACTCGC -> CCCCTGTACCTGACTCGCG
ACCCGACCTACGTGCGAGC -> CCCGACCTACGTGCGAGCA
ACCCGGGAGGCCCATGCTT -> CCCGGGAGGCCCATGCTTC
ACCCTAAATACGACTTTAG -> CCCTAAATACGACTTTAGA
ACCCTATAACGAACTATTA -> CCCTATAACGAACTATTAT
ACCCTCAGGTGAGATCTAT -> CCCTCAGGTGAGATCTATA
ACCGGGGAAAGTGGTAAAT -> CCGGGGAAAGTGGTAAATT
ACCGTGGGCGGGGACCAGG -> CCGTGGGCGGGGACCAGGT
ACCTACGTGCGAGCAAATG -> CCTACGTGCGAGCAAATGT
ACCTATAATTTGGCCTTGC -> CCTATAATTTGGCCTTGCC
ACCTATGTCGATCCGGAAA -> CCTATGTCGATCCGGAAAA
ACCTCGCATCTAGATATGA -> CCTCGCATCTAGATATGAC
ACCTCTCAGGTATGATTAA -> CCTCTCAGGTATGATTAAT
ACCTCTGATCTTCGATCTC -> CCTCTGATCTTCGATCTCA
ACCTGACTCGCGACAAGCA -> CCTGACTCGCGACAAGCAC
ACCTTACACCAAAATGCTA -> CCTTACACCAAAATGCTAA
ACCTTCAGTCCCCGAACCT -> CCTTCAGTCCCCGAACCTC
ACCTTCGAACTATTATGTT -> CCTTCGAACTATTATGTTG
ACCTTGATATAGTAGATTT -> CCTTGATATAGTAGATTTG
ACCTTTTAGTTATGCCGCA -> CCTTTTAGTTATGCCGCAG
ACCTTTTATGTGCGCTCAC -> CCTTTTATGTGCGCTCACA
ACGAACTATTATGTTGGAG -> CGAACTATTATGTTGGAGT,CGAACTATTATGTTGGAGT
ACGAACTCTTTGGTCCTTG -> CGAACTCTTTGGTCCTTGA
ACGAAGCAGTGGACAAAAC -> CGAAGCAGTGGACAAAACC
ACGACCAATTCGAATCTGC -> CGACCAATTCGAATCTGCT
ACGACTAGCCTCAGACCTA -> CGACTAGCCTCAGACCTAT
ACGACTTTAGAGGACAACC -> CGACTTTAGAGGACAACCT
ACGAGATCGCCAGAGGTGG -> CGAGATCGCCAGAGGTGGT
ACGAGGTTGGCTATCTGTC -> CGAGGTTGGCTATCTGTCT
ACGAGTGCATGCGTGCAAC -> CGAGTGCATGCGTGCAACC
ACGATGAGCCGGCCCGCGG -> CGATGAGCCGGCCCGCGGA
ACGCAAGACGATGAGCCGG -> CGCAAGACGATGAGCCGGC
ACGCAATTGGTAGAGTAAT -> CGCAATTGGTAGAGTAATG
ACGCAGAGTGAGCAATCTT -> CGCAGAGTGAGCAATCTTT
ACGCAGCGAAGCCGCGAAC -> CGCAGCGAAGCCGCGAACA
ACGCCGGATAGACGGAATC -> CGCCGGATAGACGGAATCA
ACGCCTACTTCCAGCGTGA -> CGCCTACTTCCAGCGTGAA
ACGCCTGTACGCCTACTTC -> CGCCTGTACGCCTACTTCC
ACGCGCAATGTGCGCCACA -> CGCGCAATGTGCGCCACAA
ACGCTATACCAGTCGGGAG -> CGCTATACCAGTCGGGAGA
ACGGAATCAAAGATGGTAA -> CGGAATCAAAGATGGTAAC
ACGGAGCAGTCAGCTACTA -> CGGAGCAGTCAGCTACTAC
ACGGGGAGGTGTGGCATAG -> CGGGGAGGTGTGGCATAGG
ACGGTCCTAACCACAGGCT -> CGGTCCTAACCACAGGCTC
ACGTACCCCTGTACCTGAC -> CGTACCCCTGTACCTGACT
ACGTAGAGTCCGCTTGTTG -> CGTAGAGTCCGCTTGTTGG
ACGTATTACGAGTGCATGC -> CGTATTACGAGTGCATGCG
ACGTGATGACTTGGAACTG -> CGTGATGACTTGGAACTGC
ACGTGCGAGCAAATGTGCG -> CGTGCGAGCAAATGTGCGC
ACGTGCGGAGTTGGGGCAC -> CGTGCGGAGTTGGGGCACA
ACGTTTTATCGCGACGCAA -> CGTTTTATCGCGACGCAAT
ACTAAACGAAGCAGTGGAC -> CTAAACGAAGCAGTGGACA
ACTAACGACCAATTCGAAT -> CTAACGACCAATTCGAATC
ACTAATTTCCCGGAACTGG -> CTAATTTCCCGGAACTGGA
ACTACCTTACACCAAAATG -> CTACCTTACACCAAAATGC
ACTACGCAGAGTGAGCAAT -> CTACGCAGAGTGAGCAATC
ACTACGCGCAATGTGCGCC -> CTACGCGCAATGTGCGCCA
ACTACGGAGCAGTCAGCTA -> CTACGGAGCAGTCAGCTAC
ACTAGCCTCAGACCTATGT -> CTAGCCTCAGACCTATGTC
ACTAGGCCTGGGCTCGCAA -> CTAGGCCTGGGCTCGCAAG
ACTAGGCGAATTTTAGGAA -> CTAGGCGAATTTTAGGAAG
ACTATTATGTTGGAGTGGT -> CTATTATGTTGGAGTGGTT
ACTATTATGTTGGAGTGTA -> CTATTATGTTGGAGTGTAC
ACTATTATGTTGGAGTGTG -> CTATTATGTTGGAGTGTGT
ACTATTATGTTGGAGTTAT -> CTATTATGTTGGAGTTATG
ACTCAGAATGTGAACTAAC -> CTCAGAATGTGAACTAACG
ACTCAGCTTTACCACACAG -> CTCAGCTTTACCACACAGG
ACTCGCATGATAAGTTCAA -> CTCGCATGATAAGTTCAAG
ACTCGCGACAAGCACTACG -> CTCGCGACAAGCACTACGG
ACTCTTTGGTCCTTGAGGT -> CTCTTTGGTCCTTGAGGTC
ACTGCCTCCCGCCTCTGGA -> CTGCCTCCCGCCTCTGGAG
ACTGCTTGTCTACGTACCC -> CTGCTTGTCTACGTACCCC
ACTGGAAATCGGTATAGGT -> CTGGAAATCGGTATAGGTT
ACTGGATCGATGTCCTTGG -> CTGGATCGATGTCCTTGGT
ACTGGGCAGCACAAATTAC -> CTGGGCAGCACAAATTACC
ACTGGTCGGGCGAACCCCT -> CTGGTCGGGCGAACCCCTG
ACTGTATGTCGGCTCAGGT -> CTGTATGTCGGCTCAGGTC
ACTTACATGGTCCGAGCTG -> CTTACATGGTCCGAGCTGG
ACTTACCCAATATTCTTCG -> CTTACCCAATATTCTTCGG
ACTTAGGCATATCTGCGTA -> CTTAGGCATATCTGCGTAC
ACTTCCAGCGTGAACGTGC -> CTTCCAGCGTGAACGTGCG
ACTTCGTGAATCGAACTAT -> CTTCGTGAATCGAACTATT
ACTTGACAAATGTCTCAGC -> CTTGACAAATGTCTCAGCA
ACTTGCCGGTAGTTTACAT -> CTTGCCGGTAGTTTACATA
ACTTGGAACTGCTTGTCTA -> CTTGGAACTGCTTGTCTAC
ACTTGGATCACTTGACAAA -> CTTGGATCACTTGACAAAT
ACTTTAGAGGACAACCTTG -> CTTTAGAGGACAACCTTGA
ACTTTATAGTGGTCGTGAG -> CTTTATAGTGGTCGTGAGT
AGAAACCAGTCCACTTTAT -> GAAACCAGTCCACTTTATA
AGAATGTGAACTAACGACC -> GAATGTGAACTAACGACCA
AGACATTATCTTTTTGAAA -> GACATTATCTTTTTGAAAT
AGACCTATGTCGATCCGGA -> GACCTATGTCGATCCGGAA
AGACCTTCGAACTATTATG -> GACCTTCGAACTATTATGT
AGACGATGAGCCGGCCCGC -> GACGATGAGCCGGCCCGCG
AGACGCCGGATAGACGGAA -> GACGCCGGATAGACGGAAT
AGACGGAATCAAAGATGGT -> GACGGAATCAAAGATGGTA
AGACGTAGAGTCCGCTTGT -> GACGTAGAGTCCGCTTGTT
AGACTAAACGAAGCAGTGG -> GACTAAACGAAGCAGTGGA
AGACTGGGCAGCACAAATT -> GACTGGGCAGCACAAATTA
AGACTTACCCAATATTCTT -> GACTTACCCAATATTCTTC
AGACTTCGTGAATCGAACT -> GACTTCGTGAATCGAACTA
AGAGAGGGTCAGACGCCGG -> GAGAGGGTCAGACGCCGGA
AGAGCCCTCGGGACCCTAA -> GAGCCCTCGGGACCCTAAA
AGAGGACAACCTTGATATA -> GAGGACAACCTTGATATAG
AGAGGACGCCTGTACGCCT -> GAGGACGCCTGTACGCCTA
AGAGGAGGTCTACCGGGGA -> GAGGAGGTCTACCGGGGAA
AGAGGGACGCTATACCAGT -> GAGGGACGCTATACCAGTC
AGAGGGGCGGCTTCCACCC -> GAGGGGCGGCTTCCACCCA
AGAGGGTCAGACGCCGGAT -> GAGGGTCAGACGCCGGATA
AGAGGTGGTGTGTGAAAGG -> GAGGTGGTGTGTGAAAGGG
AGAGTAATGCTGTGCTGGT -> GAGTAATGCTGTGCTGGTA
AGAGTCCGCTTGTTGGCTC -> GAGTCCGCTTGTTGGCTCG
AGAGTGAGCAATCTTTTAC -> GAGTGAGCAATCTTTTACT
AGATATGACATTAACGTTT -> GATATGACATTAACGTTTT
AGATCAATAAGCGCATTCT -> GATCAATAAGCGCATTCTA
AGATCGCCAGAGGTGGTGT -> GATCGCCAGAGGTGGTGTG
AGATCTATAGGCGAAAATC -> GATCTATAGGCGAAAATCG
AGATCTATGAATAACATGG -> GATCTATGAATAACATGGT
AGATGGTAACTTGGATCAC -> GATGGTAACTTGGATCACT
AGATTAGAGGGACGCTATA -> GATTAGAGGGACGCTATAC
AGATTATACCGTGGGCGGG -> GATTATACCGTGGGCGGGG
AGATTGGACGAACTATTAT -> GATTGGACGAACTATTATG
AGATTTGTCTCAGTTCGGA -> GATTTGTCTCAGTTCGGAA
AGCAAATGTGCGCAATTAG -> GCAAATGTGCGCAATTAGT
AGCAATCACAGGTGCAATG -> GCAATCACAGGTGCAATGT
AGCAATCTTTTACTGCCTC -> GCAATCTTTTACTGCCTCC
AGCACAAATTACCTATAAT -> GCACAAATTACCTATAATT
AGCACCCTCAGGTGAGATC -> GCACCCTCAGGTGAGATCT
AGCACTACGGAGCAGTCAG -> GCACTACGGAGCAGTCAGC
AGCAGATCAATAAGCGCAT -> GCAGATCAATAAGCGCATT
AGCAGTCAGCTACTACGCA -> GCAGTCAGCTACTACGCAG
AGCAGTGGACAAAACCAAC -> GCAGTGGACAAAACCAACC
AGCATGTGCATATAACCTC -> GCATGTGCATATAACCTCG
AGCCATCTATCTCATCGAT -> GCCATCTATCTCATCGATA
AGCCATCTGTACCCCAAAA -> GCCATCTGTACCCCAAAAG
AGCCCGAAGACTGGGCAGC -> GCCCGAAGACTGGGCAGCA
AGCCCTCGGGACCCTAAAT -> GCCCTCGGGACCCTAAATA
AGCCGCAATAGGGATGCGA -> GCCGCAATAGGGATGCGAA
AGCCGCGAACAGCAATCAC -> GCCGCGAACAGCAATCACA
AGCCGGCCCGCGGAAATCT -> GCCGGCCCGCGGAAATCTG
AGCCGTTCCTCGGACTAGG -> GCCGTTCCTCGGACTAGGC
AGCCTCAGACCTATGTCGA -> GCCTCAGACCTATGTCGAT
AGCCTCGCGCAGCCATCTA -> GCCTCGCGCAGCCATCTAT
AGCGAAGCCGCGAACAGCA -> GCGAAGCCGCGAACAGCAA
AGCGACAAAGGACCACAGG -> GCGACAAAGGACCACAGGC
AGCGACTAATTTCCCGGAA -> GCGACTAATTTCCCGGAAC
AGCGATCGTCAAGTCCGAA -> GCGATCGTCAAGTCCGAAA
AGCGATCGTTGTTTCCGCG -> GCGATCGTTGTTTCCGCGC
AGCGCATTCTACTACCTTA -> GCGCATTCTACTACCTTAC
AGCGGGGTGAGCGATCGTC -> GCGGGGTGAGCGATCGTCA
AGCGTCAGACCTTCGAACT -> GCGTCAGACCTTCGAACTA
AGCGTGAACGTGCGGAGTT -> GCGTGAACGTGCGGAGTTG
AGCTACTACGCAGAGTGAG -> GCTACTACGCAGAGTGAGC
AGCTGGGAAAATGCGGCGA -> GCTGGGAAAATGCGGCGAA
AGCTGTGGTGCGAACTGGT -> GCTGTGGTGCGAACTGGTC
AGCTTGTCACACTCGCATG -> GCTTGTCACACTCGCATGA
AGCTTTACCACACAGGAAG -> GCTTTACCACACAGGAAGC
AGGAAGACTTCGTGAATCG -> GGAAGACTTCGTGAATCGA
AGGAAGCCATCTGTACCCC -> GGAAGCCATCTGTACCCCA
AGGAAGCGTCAGACCTTCG -> GGAAGCGTCAGACCTTCGA
AGGAAGGTAAGATTGGACG -> GGAAGGTAAGATTGGACGA
AGGAAGTTACCCTATAACG -> GGAAGTTACCCTATAACGA
AGGAATTCGCCCTTGCGAC -> GGAATTCGCCCTTGCGACT
AGGACAACCTTGATATAGT -> GGACAACCTTGATATAGTA
AGGACCACAGGCTGGGAGA -> GGACCACAGGCTGGGAGAC
AGGACGCCTGTACGCCTAC -> GGACGCCTGTACGCCTACT
AGGACGTATTACGAGTGCA -> GGACGTATTACGAGTGCAT
AGGAGGTCTACCGGGGAAA -> GGAGGTCTACCGGGGAAAG
AGGCATATCTGCGTACTTA -> GGCATATCTGCGTACTTAC
AGGCCCAGAGGGGCGGCTT -> GGCCCAGAGGGGCGGCTTC
AGGCCCATGCTTCCGACCA -> GGCCCATGCTTCCGACCAG
AGGCCTGGGCTCGCAAGTG -> GGCCTGGGCTCGCAAGTGT
AGGCGAAAATCGACATGAG -> GGCGAAAATCGACATGAGA
AGGCGAATTTTAGGAAGAC -> GGCGAATTTTAGGAAGACT
AGGCGAATTTTAGGAAGCG -> GGCGAATTTTAGGAAGCGT
AGGCGAATTTTAGGAAGGT -> GGCGAATTTTAGGAAGGTA
AGGCGAATTTTAGGAAGTT -> GGCGAATTTTAGGAAGTTA
AGGCTCGGCTGCTAGAGGA -> GGCTCGGCTGCTAGAGGAC
AGGCTGGGAGACATTATCT -> GGCTGGGAGACATTATCTT
AGGGACGCTATACCAGTCG -> GGGACGCTATACCAGTCGG
AGGGATGCGAAGGGTTGAC -> GGGATGCGAAGGGTTGACG
AGGGCCGTCCTCCTTACCT -> GGGCCGTCCTCCTTACCTC
AGGGGCGGCTTCCACCCAC -> GGGGCGGCTTCCACCCACG
AGGGTCAGACGCCGGATAG -> GGGTCAGACGCCGGATAGA
AGGGTTGACGGGGAGGTGT -> GGGTTGACGGGGAGGTGTG
AGGTAAGATTGGACGAACT -> GGTAAGATTGGACGAACTA
AGGTATGATTAATATTGAT -> GGTATGATTAATATTGATC
AGGTCCACCCGGGAGGCCC -> GGTCCACCCGGGAGGCCCA
AGGTCCTTAAACGGTCCTA -> GGTCCTTAAACGGTCCTAA
AGGTCGCATAACCCGACCT -> GGTCGCATAACCCGACCTA
AGGTCTACCGGGGAAAGTG -> GGTCTACCGGGGAAAGTGG
AGGTGAAACTGGATCGATG -> GGTGAAACTGGATCGATGT
AGGTGAGATCTATAGGCGA -> GGTGAGATCTATAGGCGAA
AGGTGAGCAGATCAATAAG -> GGTGAGCAGATCAATAAGC
AGGTGCAATGTCGGCCCAG -> GGTGCAATGTCGGCCCAGG
AGGTGGGTAGAAACCAGTC -> GGTGGGTAGAAACCAGTCC
AGGTGGTGTGTGAAAGGGC -> GGTGGTGTGTGAAAGGGCC
AGGTGTGGCATAGGCGAAT -> GGTGTGGCATAGGCGAATT
AGGTTAAGCCTCGCGCAGC -> GGTTAAGCCTCGCGCAGCC
AGGTTAGCACCCTCAGGTG -> GGTTAGCACCCTCAGGTGA
AGGTTCGAGCATATATGAA -> GGTTCGAGCATATATGAAT
AGGTTGGCTATCTGTCTGT -> GGTTGGCTATCTGTCTGTG
AGTAATGCTGTGCTGGTAG -> GTAATGCTGTGCTGGTAGG
AGTACAGCGACTAATTTCC -> GTACAGCGACTAATTTCCC
AGTAGACTAAACGAAGCAG -> GTAGACTAAACGAAGCAGT
AGTAGATTTGTCTCAGTTC -> GTAGATTTGTCTCAGTTCG
AGTATAAGCCGCAATAGGG -> GTATAAGCCGCAATAGGGA
AGTCAGCTACTACGCAGAG -> GTCAGCTACTACGCAGAGT
AGTCATGTGCTGGCTATCT -> GTCATGTGCTGGCTATCTG
AGTCCACTTTATAGTGGTC -> GTCCACTTTATAGTGGTCG
AGTCCCCGAACCTCTGATC -> GTCCCCGAACCTCTGATCT
AGTCCGAAACCTTCAGTCC -> GTCCGAAACCTTCAGTCCC
AGTCCGCTTGTTGGCTCGA -> GTCCGCTTGTTGGCTCGAG
AGTCGGGAGATCTATGAAT -> GTCGGGAGATCTATGAATA
AGTGAGCAATCTTTTACTG -> GTGAGCAATCTTTTACTGC
AGTGCATGCGTGCAACCTT -> GTGCATGCGTGCAACCTTT
AGTGGACAAAACCAACCAT -> GTGGACAAAACCAACCATC
AGTGGATCCTAAAGGTGGG -> GTGGATCCTAAAGGTGGGT
AGTGGTAAATTCAGCTGTG -> GTGGTAAATTCAGCTGTGG
AGTGGTCGTGAGTATAAGC -> GTGGTCGTGAGTATAAGCC
AGTGGTTCAACTCAGCTTT -> GTGGTTCAACTCAGCTTTA
AGTGTACGAGGTTGGCTAT -> GTGTACGAGGTTGGCTATC
AGTGTCCGGAGACGTAGAG -> GTGTCCGGAGACGTAGAGT
AGTGTGTCGACTCAGAATG -> GTGTGTCGACTCAGAATGT
AGTGTGTGAGTGTGTCGAC -> GTGTGTGAGTGTGTCGACT
AGTTACCCTATAACGAACT -> GTTACCCTATAACGAACTA
AGTTATGAATCCGTTTTGC -> GTTATGAATCCGTTTTGCG
AGTTATGCCGCAGAGAGGG -> GTTATGCCGCAGAGAGGGT
AGTTCAAGCGGGGTGAGCG -> GTTCAAGCGGGGTGAGCGA
AGTTCGGAAAGTCATGTGC -> GTTCGGAAAGTCATGTGCT
AGTTGGGGCACAATTATGG -> GTTGGGGCACAATTATGGC
AGTTTACATATCAGGTTAG -> GTTTACATATCAGGTTAGC
ATAAATAGGTGAAACTGGA -> TAAATAGGTGAAACTGGAT
ATAACATGGTTATCTCTGA -> TAACATGGTTATCTCTGAC
ATAACCCGACCTACGTGCG -> TAACCCGACCTACGTGCGA
ATAACCTCGCATCTAGATA -> TAACCTCGCATCTAGATAT
ATAACGAACTATTATGTTG -> TAACGAACTATTATGTTGG
ATAAGCCGCAATAGGGATG -> TAAGCCGCAATAGGGATGC
ATAAGCGCATTCTACTACC -> TAAGCGCATTCTACTACCT
ATAAGTTCAAGCGGGGTGA -> TAAGTTCAAGCGGGGTGAG
ATAATTTGGCCTTGCCAAC -> TAATTTGGCCTTGCCAACT
ATACAGGTTCGAGCATATA -> TACAGGTTCGAGCATATAT
ATACCAGTCGGGAGATCTA -> TACCAGTCGGGAGATCTAT
ATACCGTGGGCGGGGACCA -> TACCGTGGGCGGGGACCAG
ATACGACTTTAGAGGACAA -> TACGACTTTAGAGGACAAC
ATAGACGGAATCAAAGATG -> TAGACGGAATCAAAGATGG
ATAGGCGAAAATCGACATG -> TAGGCGAAAATCGACATGA
ATAGGCGAATTTTAGGAAG -> TAGGCGAATTTTAGGAAGA
ATAGGGATGCGAAGGGTTG -> TAGGGATGCGAAGGGTTGA
ATAGGTGAAACTGGATCGA -> TAGGTGAAACTGGATCGAT
ATAGGTTAAGCCTCGCGCA -> TAGGTTAAGCCTCGCGCAG
ATAGTAGATTTGTCTCAGT -> TAGTAGATTTGTCTCAGTT
ATAGTGGTCGTGAGTATAA -> TAGTGGTCGTGAGTATAAG
ATATAACCTCGCATCTAGA -> TATAACCTCGCATCTAGAT
ATATAGTAGATTTGTCTCA -> TATAGTAGATTTGTCTCAG
ATATCAGGTTAGCACCCTC -> TATCAGGTTAGCACCCTCA
ATATCTGCGTACTTACATG -> TATCTGCGTACTTACATGG
ATATGACATTAACGTTTTA -> TATGACATTAACGTTTTAT
ATATTCTTCGGTTTACTAG -> TATTCTTCGGTTTACTAGG
ATATTGAATGACGCAAGAC -> TATTGAATGACGCAAGACG
ATATTGATCTCCCTGCAGG -> TATTGATCTCCCTGCAGGA
ATCAAAGATGGTAACTTGG -> TCAAAGATGGTAACTTGGA
ATCAATAAGCGCATTCTAC -> TCAATAAGCGCATTCTACT
ATCACAGGTGCAATGTCGG -> TCACAGGTGCAATGTCGGC
ATCACCAAAATCTCTAGAG -> TCACCAAAATCTCTAGAGG
ATCACTTGACAAATGTCTC -> TCACTTGACAAATGTCTCA
ATCAGCTTGTCACACTCGC -> TCAGCTTGTCACACTCGCA
ATCAGGTTAGCACCCTCAG -> TCAGGTTAGCACCCTCAGG
ATCCGGAAAATCAGCTTGT -> TCCGGAAAATCAGCTTGTC
ATCCGTTTTGCGTTCTATG -> TCCGTTTTGCGTTCTATGC
ATCCTAAAGGTGGGTAGAA -> TCCTAAAGGTGGGTAGAAA
ATCGAACTATTATGTTGGA -> TCGAACTATTATGTTGGAG
ATCGACATGAGACTTACCC -> TCGACATGAGACTTACCCA
ATCGATAAATAGGTGAAAC -> TCGATAAATAGGTGAAACT
ATCGATGTCCTTGGTTAGA -> TCGATGTCCTTGGTTAGAG
ATCGCCAGAGGTGGTGTGT -> TCGCCAGAGGTGGTGTGTG
ATCGCGACGCAATTGGTAG -> TCGCGACGCAATTGGTAGA
ATCGGTATAGGTTAAGCCT -> TCGGTATAGGTTAAGCCTC
ATCGTAGGAATTCGCCCTT -> TCGTAGGAATTCGCCCTTG
ATCGTCAAGTCCGAAACCT -> TCGTCAAGTCCGAAACCTT
ATCGTTGTTTCCGCGCTAA -> TCGTTGTTTCCGCGCTAAT
ATCTAGATATGACATTAAC -> TCTAGATATGACATTAACG
ATCTATAGGCGAAAATCGA -> TCTATAGGCGAAAATCGAC
ATCTATCTCATCGATAAAT -> TCTATCTCATCGATAAATA
ATCTATGAATAACATGGTT -> TCTATGAATAACATGGTTA
ATCTCAAAAATCGTAGGAA -> TCTCAAAAATCGTAGGAAT
ATCTCATCGATAAATAGGT -> TCTCATCGATAAATAGGTG
ATCTCCCTGCAGGACGTAT -> TCTCCCTGCAGGACGTATT
ATCTCTAGAGGAGGTCTAC -> TCTCTAGAGGAGGTCTACC
ATCTCTGACGAACTCTTTG -> TCTCTGACGAACTCTTTGG
ATCTGACGACTAGCCTCAG -> TCTGACGACTAGCCTCAGA
ATCTGCGAAGATTAGAGGG -> TCTGCGAAGATTAGAGGGA
ATCTGCGTACTTACATGGT -> TCTGCGTACTTACATGGTC
ATCTGCTTTACCTTTTATG -> TCTGCTTTACCTTTTATGT
ATCTGGGGTTATACAGGTT -> TCTGGGGTTATACAGGTTC
ATCTGTACCCCAAAAGCCC -> TCTGTACCCCAAAAGCCCG
ATCTGTCTGTGACTACGCG -> TCTGTCTGTGACTACGCGC
ATCTTCGATCTCAAAAATC -> TCTTCGATCTCAAAAATCG
ATCTTTAGGTCCACCCGGG -> TCTTTAGGTCCACCCGGGA
ATCTTTTACTGCCTCCCGC -> TCTTTTACTGCCTCCCGCC
ATCTTTTTGAAATCTGGGG -> TCTTTTTGAAATCTGGGGT
ATGAATAACATGGTTATCT -> TGAATAACATGGTTATCTC
ATGAATCCGTTTTGCGTTC -> TGAATCCGTTTTGCGTTCT
ATGACATTAACGTTTTATC -> TGACATTAACGTTTTATCG
ATGACGCAAGACGATGAGC -> TGACGCAAGACGATGAGCC
ATGACTTGGAACTGCTTGT -> TGACTTGGAACTGCTTGTC
ATGAGACTTACCCAATATT -> TGAGACTTACCCAATATTC
ATGAGATTATACCGTGGGC -> TGAGATTATACCGTGGGCG
ATGAGCCGGCCCGCGGAAA -> TGAGCCGGCCCGCGGAAAT
ATGATAAGTTCAAGCGGGG -> TGATAAGTTCAAGCGGGGT
ATGATTAATATTGATCTCC -> TGATTAATATTGATCTCCC
ATGCCGCAGAGAGGGTCAG -> TGCCGCAGAGAGGGTCAGA
ATGCGAAGGGTTGACGGGG -> TGCGAAGGGTTGACGGGGA
ATGCGGCGAAGTAGACTAA -> TGCGGCGAAGTAGACTAAA
ATGCGGGCGATGAGATTAT -> TGCGGGCGATGAGATTATA
ATGCGTGCAACCTTTTAGT -> TGCGTGCAACCTTTTAGTT
ATGCTAACGAGATCGCCAG -> TGCTAACGAGATCGCCAGA
ATGCTGTGCTGGTAGGCGA -> TGCTGTGCTGGTAGGCGAA
ATGCTTCCGACCAGCGACA -> TGCTTCCGACCAGCGACAA
ATGGCTTGTCATTTCTACA -> TGGCTTGTCATTTCTACAA
ATGGTAACTTGGATCACTT -> TGGTAACTTGGATCACTTG
ATGGTACGCAGCGAAGCCG -> TGGTACGCAGCGAAGCCGC
ATGGTCCGAGCTGGGAAAA -> TGGTCCGAGCTGGGAAAAT
ATGGTTATCTCTGACGAAC -> TGGTTATCTCTGACGAACT
ATGTCCTTGGTTAGAGCCC -> TGTCCTTGGTTAGAGCCCT
ATGTCGATCCGGAAAATCA -> TGTCGATCCGGAAAATCAG
ATGTCGGCCCAGGCCCAGA -> TGTCGGCCCAGGCCCAGAG
ATGTCGGCTCAGGTCCTTA -> TGTCGGCTCAGGTCCTTAA
ATGTCTCAGCATGTGCATA -> TGTCTCAGCATGTGCATAT
ATGTGAACTAACGACCAAT -> TGTGAACTAACGACCAATT
ATGTGCATATAACCTCGCA -> TGTGCATATAACCTCGCAT
ATGTGCGCAATTAGTACAG -> TGTGCGCAATTAGTACAGC
ATGTGCGCCACAAGCCGTT -> TGTGCGCCACAAGCCGTTC
ATGTGCGCTCACATTCGTT -> TGTGCGCTCACATTCGTTG
ATGTGCTGGCTATCTGACG -> TGTGCTGGCTATCTGACGA
ATGTTGGAGTGGTTCAACT -> TGTTGGAGTGGTTCAACTC
ATGTTGGAGTGTACGAGGT -> TGTTGGAGTGTACGAGGTT
ATGTTGGAGTGTGTGAGTG -> TGTTGGAGTGTGTGAGTGT
ATGTTGGAGTTATGAATCC -> TGTTGGAGTTATGAATCCG
ATTAACGTTTTATCGCGAC -> TTAACGTTTTATCGCGACG
ATTAATATTGATCTCCCTG -> TTAATATTGATCTCCCTGC
ATTACCTATAATTTGGCCT -> TTACCTATAATTTGGCCTT
ATTACGAGTGCATGCGTGC -> TTACGAGTGCATGCGTGCA
ATTAGAGGGACGCTATACC -> TTAGAGGGACGCTATACCA
ATTAGTACAGCGACTAATT -> TTAGTACAGCGACTAATTT
ATTATACCGTGGGCGGGGA -> TTATACCGTGGGCGGGGAC
ATTATCTTTTTGAAATCTG -> TTATCTTTTTGAAATCTGG
ATTATGGCTTGTCATTTCT -> TTATGGCTTGTCATTTCTA
ATTATGTTGGAGTGGTTCA -> TTATGTTGGAGTGGTTCAA
ATTATGTTGGAGTGTACGA -> TTATGTTGGAGTGTACGAG
ATTATGTTGGAGTGTGTGA -> TTATGTTGGAGTGTGTGAG
ATTATGTTGGAGTTATGAA -> TTATGTTGGAGTTATGAAT
ATTCAGCTGTGGTGCGAAC -> TTCAGCTGTGGTGCGAACT
ATTCGAATCTGCTTTACCT -> TTCGAATCTGCTTTACCTT
ATTCGCCCTTGCGACTGTA -> TTCGCCCTTGCGACTGTAT
ATTCGGCCAAATATTGAAT -> TTCGGCCAAATATTGAATG
ATTCGTTGCAATTCGGCCA -> TTCGTTGCAATTCGGCCAA
ATTCTACTACCTTACACCA -> TTCTACTACCTTACACCAA
ATTCTTCGGTTTACTAGGC -> TTCTTCGGTTTACTAGGCC
ATTGAATGACGCAAGACGA -> TTGAATGACGCAAGACGAT
ATTGATCTCCCTGCAGGAC -> TTGATCTCCCTGCAGGACG
ATTGGACGAACTATTATGT -> TTGGACGAACTATTATGTT
ATTGGTAGAGTAATGCTGT -> TTGGTAGAGTAATGCTGTG
ATTTCCCGGAACTGGAAAT -> TTTCCCGGAACTGGAAATC
ATTTCTACAATGGTACGCA -> TTTCTACAATGGTACGCAG
ATTTGGCCTTGCCAACTTA -> TTTGGCCTTGCCAACTTAG
ATTTGTCTCAGTTCGGAAA -> TTTGTCTCAGTTCGGAAAG
ATTTTAGGAAGACTTCGTG -> TTTTAGGAAGACTTCGTGA
ATTTTAGGAAGCGTCAGAC -> TTTTAGGAAGCGTCAGACC
ATTTTAGGAAGGTAAGATT -> TTTTAGGAAGGTAAGATTG
ATTTTAGGAAGTTACCCTA -> TTTTAGGAAGTTACCCTAT
CAAAAATCGTAGGAATTCG -> AAAAATCGTAGGAATTCGC
CAAAACCAACCATCTTTAG -> AAAACCAACCATCTTTAGG
CAAAAGCCCGAAGACTGGG -> AAAAGCCCGAAGACTGGGC
CAAAATCTCTAGAGGAGGT -> AAAATCTCTAGAGGAGGTC
CAAAATGCTAACGAGATCG -> AAAATGCTAACGAGATCGC
CAAAGATGGTAACTTGGAT -> AAAGATGGTAACTTGGATC
CAAAGGACCACAGGCTGGG -> AAAGGACCACAGGCTGGGA
CAAATATTGAATGACGCAA -> AAATATTGAATGACGCAAG
CAAATGTCTCAGCATGTGC -> AAATGTCTCAGCATGTGCA
CAAATGTGCGCAATTAGTA -> AAATGTGCGCAATTAGTAC
CAAATTACCTATAATTTGG -> AAATTACCTATAATTTGGC
CAACCATCTTTAGGTCCAC -> AACCATCTTTAGGTCCACC
CAACCTTGATATAGTAGAT -> AACCTTGATATAGTAGATT
CAACCTTTTAGTTATGCCG -> AACCTTTTAGTTATGCCGC
CAACTCAGCTTTACCACAC -> AACTCAGCTTTACCACACA
CAACTTAGGCATATCTGCG -> AACTTAGGCATATCTGCGT
CAAGACGATGAGCCGGCCC -> AAGACGATGAGCCGGCCCG
CAAGCACTACGGAGCAGTC -> AAGCACTACGGAGCAGTCA
CAAGCCGTTCCTCGGACTA -> AAGCCGTTCCTCGGACTAG
CAAGCGGGGTGAGCGATCG -> AAGCGGGGTGAGCGATCGT
CAAGTCCGAAACCTTCAGT -> AAGTCCGAAACCTTCAGTC
CAAGTGTCCGGAGACGTAG -> AAGTGTCCGGAGACGTAGA
CAATAAGCGCATTCTACTA -> AATAAGCGCATTCTACTAC
CAATAGGGATGCGAAGGGT -> AATAGGGATGCGAAGGGTT
CAATATTCTTCGGTTTACT -> AATATTCTTCGGTTTACTA
CAATCACAGGTGCAATGTC -> AATCACAGGTGCAATGTCG
CAATCTTTTACTGCCTCCC -> AATCTTTTACTGCCTCCCG
CAATGGTACGCAGCGAAGC -> AATGGTACGCAGCGAAGCC
CAATGTCGGCCCAGGCCCA -> AATGTCGGCCCAGGCCCAG
CAATGTGCGCCACAAGCCG -> AATGTGCGCCACAAGCCGT
CAATTAGTACAGCGACTAA -> AATTAGTACAGCGACTAAT
CAATTATGGCTTGTCATTT -> AATTATGGCTTGTCATTTC
CAATTCGAATCTGCTTTAC -> AATTCGAATCTGCTTTACC
CAATTCGGCCAAATATTGA -> AATTCGGCCAAATATTGAA
CAATTGGTAGAGTAATGCT -> AATTGGTAGAGTAATGCTG
CACAAATTACCTATAATTT -> ACAAATTACCTATAATTTG
CACAAGCCGTTCCTCGGAC -> ACAAGCCGTTCCTCGGACT
CACAATTATGGCTTGTCAT -> ACAATTATGGCTTGTCATT
CACACAGGAAGCCATCTGT -> ACACAGGAAGCCATCTGTA
CACACTCGCATGATAAGTT -> ACACTCGCATGATAAGTTC
CACAGGAAGCCATCTGTAC -> ACAGGAAGCCATCTGTACC
CACAGGCTCGGCTGCTAGA -> ACAGGCTCGGCTGCTAGAG
CACAGGCTGGGAGACATTA -> ACAGGCTGGGAGACATTAT
CACAGGTGCAATGTCGGCC -> ACAGGTGCAATGTCGGCCC
CACATTCGTTGCAATTCGG -> ACATTCGTTGCAATTCGGC
CACCAAAATCTCTAGAGGA -> ACCAAAATCTCTAGAGGAG
CACCAAAATGCTAACGAGA -> ACCAAAATGCTAACGAGAT
CACCCACGTGATGACTTGG -> ACCCACGTGATGACTTGGA
CACCCGGGAGGCCCATGCT -> ACCCGGGAGGCCCATGCTT
CACCCTCAGGTGAGATCTA -> ACCCTCAGGTGAGATCTAT
CACGTGATGACTTGGAACT -> ACGTGATGACTTGGAACTG
CACTACGGAGCAGTCAGCT -> ACTACGGAGCAGTCAGCTA
CACTCGCATGATAAGTTCA -> ACTCGCATGATAAGTTCAA
CACTTGACAAATGTCTCAG -> ACTTGACAAATGTCTCAGC
CACTTGCCGGTAGTTTACA -> ACTTGCCGGTAGTTTACAT
CACTTTATAGTGGTCGTGA -> ACTTTATAGTGGTCGTGAG
CAGAATGTGAACTAACGAC -> AGAATGTGAACTAACGACC
CAGACCTATGTCGATCCGG -> AGACCTATGTCGATCCGGA
CAGACCTTCGAACTATTAT -> AGACCTTCGAACTATTATG
CAGACGCCGGATAGACGGA -> AGACGCCGGATAGACGGAA
CAGAGAGGGTCAGACGCCG -> AGAGAGGGTCAGACGCCGG
CAGAGGGGCGGCTTCCACC -> AGAGGGGCGGCTTCCACCC
CAGAGGTGGTGTGTGAAAG -> AGAGGTGGTGTGTGAAAGG
CAGAGTGAGCAATCTTTTA -> AGAGTGAGCAATCTTTTAC
CAGATCAATAAGCGCATTC -> AGATCAATAAGCGCATTCT
CAGCAATCACAGGTGCAAT -> AGCAATCACAGGTGCAATG
CAGCACAAATTACCTATAA -> AGCACAAATTACCTATAAT
CAGCATGTGCATATAACCT -> AGCATGTGCATATAACCTC
CAGCCATCTATCTCATCGA -> AGCCATCTATCTCATCGAT
CAGCGAAGCCGCGAACAGC -> AGCGAAGCCGCGAACAGCA
CAGCGACAAAGGACCACAG -> AGCGACAAAGGACCACAGG
CAGCGACTAATTTCCCGGA -> AGCGACTAATTTCCCGGAA
CAGCGTGAACGTGCGGAGT -> AGCGTGAACGTGCGGAGTT
CAGCTACTACGCAGAGTGA -> AGCTACTACGCAGAGTGAG
CAGCTGTGGTGCGAACTGG -> AGCTGTGGTGCGAACTGGT
CAGCTTGTCACACTCGCAT -> AGCTTGTCACACTCGCATG
CAGCTTTACCACACAGGAA -> AGCTTTACCACACAGGAAG
CAGGAAGCCATCTGTACCC -> AGGAAGCCATCTGTACCCC
CAGGACGTATTACGAGTGC -> AGGACGTATTACGAGTGCA
CAGGCCCAGAGGGGCGGCT -> AGGCCCAGAGGGGCGGCTT
CAGGCTCGGCTGCTAGAGG -> AGGCTCGGCTGCTAGAGGA
CAGGCTGGGAGACATTATC -> AGGCTGGGAGACATTATCT
CAGGTATGATTAATATTGA -> AGGTATGATTAATATTGAT
CAGGTCCTTAAACGGTCCT -> AGGTCCTTAAACGGTCCTA
CAGGTGAGATCTATAGGCG -> AGGTGAGATCTATAGGCGA
CAGGTGAGCAGATCAATAA -> AGGTGAGCAGATCAATAAG
CAGGTGCAATGTCGGCCCA -> AGGTGCAATGTCGGCCCAG
CAGGTTAGCACCCTCAGGT -> AGGTTAGCACCCTCAGGTG
CAGGTTCGAGCATATATGA -> AGGTTCGAGCATATATGAA
CAGTCAGCTACTACGCAGA -> AGTCAGCTACTACGCAGAG
CAGTCCACTTTATAGTGGT -> AGTCCACTTTATAGTGGTC
CAGTCCCCGAACCTCTGAT -> AGTCCCCGAACCTCTGATC
CAGTCGGGAGATCTATGAA -> AGTCGGGAGATCTATGAAT
CAGTGGACAAAACCAACCA -> AGTGGACAAAACCAACCAT
CAGTTCGGAAAGTCATGTG -> AGTTCGGAAAGTCATGTGC
CATAACCCGACCTACGTGC -> ATAACCCGACCTACGTGCG
CATAGGCGAATTTTAGGAA -> ATAGGCGAATTTTAGGAAG
CATATAACCTCGCATCTAG -> ATATAACCTCGCATCTAGA
CATATCAGGTTAGCACCCT -> ATATCAGGTTAGCACCCTC
CATATCTGCGTACTTACAT -> ATATCTGCGTACTTACATG
CATCGATAAATAGGTGAAA -> ATCGATAAATAGGTGAAAC
CATCTAGATATGACATTAA -> ATCTAGATATGACATTAAC
CATCTATCTCATCGATAAA -> ATCTATCTCATCGATAAAT
CATCTGTACCCCAAAAGCC -> ATCTGTACCCCAAAAGCCC
CATCTTTAGGTCCACCCGG -> ATCTTTAGGTCCACCCGGG
CATGAGACTTACCCAATAT -> ATGAGACTTACCCAATATT
CATGATAAGTTCAAGCGGG -> ATGATAAGTTCAAGCGGGG
CATGCGTGCAACCTTTTAG -> ATGCGTGCAACCTTTTAGT
CATGCTTCCGACCAGCGAC -> ATGCTTCCGACCAGCGACA
CATGGTCCGAGCTGGGAAA -> ATGGTCCGAGCTGGGAAAA
CATGGTTATCTCTGACGAA -> ATGGTTATCTCTGACGAAC
CATGTGCATATAACCTCGC -> ATGTGCATATAACCTCGCA
CATGTGCTGGCTATCTGAC -> ATGTGCTGGCTATCTGACG
CATTAACGTTTTATCGCGA -> ATTAACGTTTTATCGCGAC
CATTATCTTTTTGAAATCT -> ATTATCTTTTTGAAATCTG
CATTCGTTGCAATTCGGCC -> ATTCGTTGCAATTCGGCCA
CATTCTACTACCTTACACC -> ATTCTACTACCTTACACCA
CATTTCTACAATGGTACGC -> ATTTCTACAATGGTACGCA
CCAAAAGCCCGAAGACTGG -> CAAAAGCCCGAAGACTGGG
CCAAAATCTCTAGAGGAGG -> CAAAATCTCTAGAGGAGGT
CCAAAATGCTAACGAGATC -> CAAAATGCTAACGAGATCG
CCAAATATTGAATGACGCA -> CAAATATTGAATGACGCAA
CCAACCATCTTTAGGTCCA -> CAACCATCTTTAGGTCCAC
CCAACTTAGGCATATCTGC -> CAACTTAGGCATATCTGCG
CCAATATTCTTCGGTTTAC -> CAATATTCTTCGGTTTACT
CCAATTCGAATCTGCTTTA -> CAATTCGAATCTGCTTTAC
CCACAAGCCGTTCCTCGGA -> CACAAGCCGTTCCTCGGAC
CCACACAGGAAGCCATCTG -> CACACAGGAAGCCATCTGT
CCACAGGCTCGGCTGCTAG -> CACAGGCTCGGCTGCTAGA
CCACAGGCTGGGAGACATT -> CACAGGCTGGGAGACATTA
CCACCCACGTGATGACTTG -> CACCCACGTGATGACTTGG
CCACCCGGGAGGCCCATGC -> CACCCGGGAGGCCCATGCT
CCACGTGATGACTTGGAAC -> CACGTGATGACTTGGAACT
CCACTTGCCGGTAGTTTAC -> CACTTGCCGGTAGTTTACA
CCACTTTATAGTGGTCGTG -> CACTTTATAGTGGTCGTGA
CCAGAGGGGCGGCTTCCAC -> CAGAGGGGCGGCTTCCACC
CCAGAGGTGGTGTGTGAAA -> CAGAGGTGGTGTGTGAAAG
CCAGCGACAAAGGACCACA -> CAGCGACAAAGGACCACAG
CCAGCGTGAACGTGCGGAG -> CAGCGTGAACGTGCGGAGT
CCAGGCCCAGAGGGGCGGC -> CAGGCCCAGAGGGGCGGCT
CCAGGTGAGCAGATCAATA -> CAGGTGAGCAGATCAATAA
CCAGTCCACTTTATAGTGG -> CAGTCCACTTTATAGTGGT
CCAGTCGGGAGATCTATGA -> CAGTCGGGAGATCTATGAA
CCATCTATCTCATCGATAA -> CATCTATCTCATCGATAAA
CCATCTGTACCCCAAAAGC -> CATCTGTACCCCAAAAGCC
CCATCTTTAGGTCCACCCG -> CATCTTTAGGTCCACCCGG
CCATGCTTCCGACCAGCGA -> CATGCTTCCGACCAGCGAC
CCCAAAAGCCCGAAGACTG -> CCAAAAGCCCGAAGACTGG
CCCAATATTCTTCGGTTTA -> CCAATATTCTTCGGTTTAC
CCCACGTGATGACTTGGAA -> CCACGTGATGACTTGGAAC
CCCAGAGGGGCGGCTTCCA -> CCAGAGGGGCGGCTTCCAC
CCCAGGCCCAGAGGGGCGG -> CCAGGCCCAGAGGGGCGGC
CCCATGCTTCCGACCAGCG -> CCATGCTTCCGACCAGCGA
CCCCAAAAGCCCGAAGACT -> CCCAAAAGCCCGAAGACTG
CCCCGAACCTCTGATCTTC -> CCCGAACCTCTGATCTTCG
CCCCTGCGTCGGTTTTAGG -> CCCTGCGTCGGTTTTAGGC
CCCCTGTACCTGACTCGCG -> CCCTGTACCTGACTCGCGA
CCCGAACCTCTGATCTTCG -> CCGAACCTCTGATCTTCGA
CCCGAAGACTGGGCAGCAC -> CCGAAGACTGGGCAGCACA
CCCGACCTACGTGCGAGCA -> CCGACCTACGTGCGAGCAA
CCCGCCTCTGGAGTGGATC -> CCGCCTCTGGAGTGGATCC
CCCGCGGAAATCTGCGAAG -> CCGCGGAAATCTGCGAAGA
CCCGGAACTGGAAATCGGT -> CCGGAACTGGAAATCGGTA
CCCGGGAGGCCCATGCTTC -> CCGGGAGGCCCATGCTTCC
CCCTAAATACGACTTTAGA -> CCTAAATACGACTTTAGAG
CCCTATAACGAACTATTAT -> CCTATAACGAACTATTATG
CCCTCAGGTGAGATCTATA -> CCTCAGGTGAGATCTATAG
CCCTCGGGACCCTAAATAC -> CCTCGGGACCCTAAATACG
CCCTGCAGGACGTATTACG -> CCTGCAGGACGTATTACGA
CCCTGCGTCGGTTTTAGGC -> CCTGCGTCGGTTTTAGGCG
CCCTGTACCTGACTCGCGA -> CCTGTACCTGACTCGCGAC
CCCTTGCGACTGTATGTCG -> CCTTGCGACTGTATGTCGG
CCGAAACCTTCAGTCCCCG -> CGAAACCTTCAGTCCCCGA
CCGAACCTCTGATCTTCGA -> CGAACCTCTGATCTTCGAT
CCGAAGACTGGGCAGCACA -> CGAAGACTGGGCAGCACAA
CCGACCAGCGACAAAGGAC -> CGACCAGCGACAAAGGACC
CCGACCTACGTGCGAGCAA -> CGACCTACGTGCGAGCAAA
CCGAGCTGGGAAAATGCGG -> CGAGCTGGGAAAATGCGGC
CCGCAATAGGGATGCGAAG -> CGCAATAGGGATGCGAAGG
CCGCAGAGAGGGTCAGACG -> CGCAGAGAGGGTCAGACGC
CCGCCTCTGGAGTGGATCC -> CGCCTCTGGAGTGGATCCT
CCGCGAACAGCAATCACAG -> CGCGAACAGCAATCACAGG
CCGCGCTAATCACCAAAAT -> CGCGCTAATCACCAAAATC
CCGCGGAAATCTGCGAAGA -> CGCGGAAATCTGCGAAGAT
CCGCTTGTTGGCTCGAGCG -> CGCTTGTTGGCTCGAGCGA
CCGGAAAATCAGCTTGTCA -> CGGAAAATCAGCTTGTCAC
CCGGAACTGGAAATCGGTA -> CGGAACTGGAAATCGGTAT
CCGGAGACGTAGAGTCCGC -> CGGAGACGTAGAGTCCGCT
CCGGATAGACGGAATCAAA -> CGGATAGACGGAATCAAAG
CCGGCCCGCGGAAATCTGC -> CGGCCCGCGGAAATCTGCG
CCGGGAGGCCCATGCTTCC -> CGGGAGGCCCATGCTTCCG
CCGGGGAAAGTGGTAAATT -> CGGGGAAAGTGGTAAATTC
CCGGTAGTTTACATATCAG -> CGGTAGTTTACATATCAGG
CCGTCCTCCTTACCTCTCA -> CGTCCTCCTTACCTCTCAG
CCGTGGGCGGGGACCAGGT -> CGTGGGCGGGGACCAGGTG
CCGTTCCTCGGACTAGGCG -> CGTTCCTCGGACTAGGCGA
CCGTTTTGCGTTCTATGCG -> CGTTTTGCGTTCTATGCGG
CCTAAAGGTGGGTAGAAAC -> CTAAAGGTGGGTAGAAACC
CCTAAATACGACTTTAGAG -> CTAAATACGACTTTAGAGG
CCTAACCACAGGCTCGGCT -> CTAACCACAGGCTCGGCTG
CCTACGTGCGAGCAAATGT -> CTACGTGCGAGCAAATGTG
CCTACTTCCAGCGTGAACG -> CTACTTCCAGCGTGAACGT
CCTATAACGAACTATTATG -> CTATAACGAACTATTATGT
CCTATAATTTGGCCTTGCC -> CTATAATTTGGCCTTGCCA
CCTATGTCGATCCGGAAAA -> CTATGTCGATCCGGAAAAT
CCTCAGACCTATGTCGATC -> CTCAGACCTATGTCGATCC
CCTCAGGTGAGATCTATAG -> CTCAGGTGAGATCTATAGG
CCTCCCGCCTCTGGAGTGG -> CTCCCGCCTCTGGAGTGGA
CCTCCTTACCTCTCAGGTA -> CTCCTTACCTCTCAGGTAT
CCTCGCATCTAGATATGAC -> CTCGCATCTAGATATGACA
CCTCGCGCAGCCATCTATC -> CTCGCGCAGCCATCTATCT
CCTCGGACTAGGCGAATTT -> CTCGGACTAGGCGAATTTT
CCTCGGGACCCTAAATACG -> CTCGGGACCCTAAATACGA
CCTCTCAGGTATGATTAAT -> CTCTCAGGTATGATTAATA
CCTCTGATCTTCGATCTCA -> CTCTGATCTTCGATCTCAA
CCTCTGGAGTGGATCCTAA -> CTCTGGAGTGGATCCTAAA
CCTGACTCGCGACAAGCAC -> CTGACTCGCGACAAGCACT
CCTGCAGGACGTATTACGA -> CTGCAGGACGTATTACGAG
CCTGCGTCGGTTTTAGGCG -> CTGCGTCGGTTTTAGGCGA
CCTGGGCTCGCAAGTGTCC -> CTGGGCTCGCAAGTGTCCG
CCTGTACCTGACTCGCGAC -> CTGTACCTGACTCGCGACA
CCTGTACGCCTACTTCCAG -> CTGTACGCCTACTTCCAGC
CCTTAAACGGTCCTAACCA -> CTTAAACGGTCCTAACCAC
CCTTACACCAAAATGCTAA -> CTTACACCAAAATGCTAAC
CCTTACCTCTCAGGTATGA -> CTTACCTCTCAGGTATGAT
CCTTCAGTCCCCGAACCTC -> CTTCAGTCCCCGAACCTCT
CCTTCGAACTATTATGTTG -> CTTCGAACTATTATGTTGG
CCTTGAGGTCGCATAACCC -> CTTGAGGTCGCATAACCCG
CCTTGATATAGTAGATTTG -> CTTGATATAGTAGATTTGT
CCTTGCCAACTTAGGCATA -> CTTGCCAACTTAGGCATAT
CCTTGCGACTGTATGTCGG -> CTTGCGACTGTATGTCGGC
CCTTGGTTAGAGCCCTCGG -> CTTGGTTAGAGCCCTCGGG
CCTTTTAGTTATGCCGCAG -> CTTTTAGTTATGCCGCAGA
CCTTTTATGTGCGCTCACA -> CTTTTATGTGCGCTCACAT
CGAAAATCGACATGAGACT -> GAAAATCGACATGAGACTT
CGAAACCTTCAGTCCCCGA -> GAAACCTTCAGTCCCCGAA
CGAACAGCAATCACAGGTG -> GAACAGCAATCACAGGTGC
CGAACCCCTGCGTCGGTTT -> GAACCCCTGCGTCGGTTTT
CGAACCTCTGATCTTCGAT -> GAACCTCTGATCTTCGATC
CGAACTATTATGTTGGAGT -> GAACTATTATGTTGGAGTG,GAACTATTATGTTGGAGTG,GAACTATTATGTTGGAGTG,GAACTATTATGTTGGAGTT
CGAACTCTTTGGTCCTTGA -> GAACTCTTTGGTCCTTGAG
CGAACTGGTCGGGCGAACC -> GAACTGGTCGGGCGAACCC
CGAAGACTGGGCAGCACAA -> GAAGACTGGGCAGCACAAA
CGAAGATTAGAGGGACGCT -> GAAGATTAGAGGGACGCTA
CGAAGCAGTGGACAAAACC -> GAAGCAGTGGACAAAACCA
CGAAGCCGCGAACAGCAAT -> GAAGCCGCGAACAGCAATC
CGAAGGGTTGACGGGGAGG -> GAAGGGTTGACGGGGAGGT
CGAAGTAGACTAAACGAAG -> GAAGTAGACTAAACGAAGC
CGAATCTGCTTTACCTTTT -> GAATCTGCTTTACCTTTTA
CGAATTTTAGGAAGACTTC -> GAATTTTAGGAAGACTTCG
CGAATTTTAGGAAGCGTCA -> GAATTTTAGGAAGCGTCAG
CGAATTTTAGGAAGGTAAG -> GAATTTTAGGAAGGTAAGA
CGAATTTTAGGAAGTTACC -> GAATTTTAGGAAGTTACCC
CGACAAAGGACCACAGGCT -> GACAAAGGACCACAGGCTG
CGACAAGCACTACGGAGCA -> GACAAGCACTACGGAGCAG
CGACATGAGACTTACCCAA -> GACATGAGACTTACCCAAT
CGACCAATTCGAATCTGCT -> GACCAATTCGAATCTGCTT
CGACCAGCGACAAAGGACC -> GACCAGCGACAAAGGACCA
CGACCTACGTGCGAGCAAA -> GACCTACGTGCGAGCAAAT
CGACGCAATTGGTAGAGTA -> GACGCAATTGGTAGAGTAA
CGACTAATTTCCCGGAACT -> GACTAATTTCCCGGAACTG
CGACTAGCCTCAGACCTAT -> GACTAGCCTCAGACCTATG
CGACTCAGAATGTGAACTA -> GACTCAGAATGTGAACTAA
CGACTGTATGTCGGCTCAG -> GACTGTATGTCGGCTCAGG
CGACTTTAGAGGACAACCT -> GACTTTAGAGGACAACCTT
CGAGATCGCCAGAGGTGGT -> GAGATCGCCAGAGGTGGTG
CGAGCAAATGTGCGCAATT -> GAGCAAATGTGCGCAATTA
CGAGCATATATGAATTCGG -> GAGCATATATGAATTCGGC
CGAGCGATCGTTGTTTCCG -> GAGCGATCGTTGTTTCCGC
CGAGCTGGGAAAATGCGGC -> GAGCTGGGAAAATGCGGCG
CGAGGTTGGCTATCTGTCT -> GAGGTTGGCTATCTGTCTG
CGAGTGCATGCGTGCAACC -> GAGTGCATGCGTGCAACCT
CGATAAATAGGTGAAACTG -> GATAAATAGGTGAAACTGG
CGATCCGGAAAATCAGCTT -> GATCCGGAAAATCAGCTTG
CGATCGTCAAGTCCGAAAC -> GATCGTCAAGTCCGAAACC
CGATCGTTGTTTCCGCGCT -> GATCGTTGTTTCCGCGCTA
CGATCTCAAAAATCGTAGG -> GATCTCAAAAATCGTAGGA
CGATGAGATTATACCGTGG -> GATGAGATTATACCGTGGG
CGATGAGCCGGCCCGCGGA -> GATGAGCCGGCCCGCGGAA
CGATGTCCTTGGTTAGAGC -> GATGTCCTTGGTTAGAGCC
CGCAAGACGATGAGCCGGC -> GCAAGACGATGAGCCGGCC
CGCAAGTGTCCGGAGACGT -> GCAAGTGTCCGGAGACGTA
CGCAATAGGGATGCGAAGG -> GCAATAGGGATGCGAAGGG
CGCAATGTGCGCCACAAGC -> GCAATGTGCGCCACAAGCC
CGCAATTAGTACAGCGACT -> GCAATTAGTACAGCGACTA
CGCAATTGGTAGAGTAATG -> GCAATTGGTAGAGTAATGC
CGCAGAGAGGGTCAGACGC -> GCAGAGAGGGTCAGACGCC
CGCAGAGTGAGCAATCTTT -> GCAGAGTGAGCAATCTTTT
CGCAGCCATCTATCTCATC -> GCAGCCATCTATCTCATCG
CGCAGCGAAGCCGCGAACA -> GCAGCGAAGCCGCGAACAG
CGCATAACCCGACCTACGT -> GCATAACCCGACCTACGTG
CGCATCTAGATATGACATT -> GCATCTAGATATGACATTA
CGCATGATAAGTTCAAGCG -> GCATGATAAGTTCAAGCGG
CGCATTCTACTACCTTACA -> GCATTCTACTACCTTACAC
CGCCACAAGCCGTTCCTCG -> GCCACAAGCCGTTCCTCGG
CGCCAGAGGTGGTGTGTGA -> GCCAGAGGTGGTGTGTGAA
CGCCCTTGCGACTGTATGT -> GCCCTTGCGACTGTATGTC
CGCCGGATAGACGGAATCA -> GCCGGATAGACGGAATCAA
CGCCTACTTCCAGCGTGAA -> GCCTACTTCCAGCGTGAAC
CGCCTCTGGAGTGGATCCT -> GCCTCTGGAGTGGATCCTA
CGCCTGTACGCCTACTTCC -> GCCTGTACGCCTACTTCCA
CGCGAACAGCAATCACAGG -> GCGAACAGCAATCACAGGT
CGCGACAAGCACTACGGAG -> GCGACAAGCACTACGGAGC
CGCGACGCAATTGGTAGAG -> GCGACGCAATTGGTAGAGT
CGCGCAATGTGCGCCACAA -> GCGCAATGTGCGCCACAAG
CGCGCAGCCATCTATCTCA -> GCGCAGCCATCTATCTCAT
CGCGCTAATCACCAAAATC -> GCGCTAATCACCAAAATCT
CGCGGAAATCTGCGAAGAT -> GCGGAAATCTGCGAAGATT
CGCTAATCACCAAAATCTC -> GCTAATCACCAAAATCTCT
CGCTATACCAGTCGGGAGA -> GCTATACCAGTCGGGAGAT
CGCTCACATTCGTTGCAAT -> GCTCACATTCGTTGCAATT
CGCTTGTTGGCTCGAGCGA -> GCTTGTTGGCTCGAGCGAT
CGGAAAATCAGCTTGTCAC -> GGAAAATCAGCTTGTCACA
CGGAAAGTCATGTGCTGGC -> GGAAAGTCATGTGCTGGCT
CGGAAATCTGCGAAGATTA -> GGAAATCTGCGAAGATTAG
CGGAACTGGAAATCGGTAT -> GGAACTGGAAATCGGTATA
CGGAATCAAAGATGGTAAC -> GGAATCAAAGATGGTAACT
CGGACTAGGCGAATTTTAG -> GGACTAGGCGAATTTTAGG
CGGAGACGTAGAGTCCGCT -> GGAGACGTAGAGTCCGCTT
CGGAGCAGTCAGCTACTAC -> GGAGCAGTCAGCTACTACG
CGGAGTTGGGGCACAATTA -> GGAGTTGGGGCACAATTAT
CGGATAGACGGAATCAAAG -> GGATAGACGGAATCAAAGA
CGGCCAAATATTGAATGAC -> GGCCAAATATTGAATGACG
CGGCCCAGGCCCAGAGGGG -> GGCCCAGGCCCAGAGGGGC
CGGCCCGCGGAAATCTGCG -> GGCCCGCGGAAATCTGCGA
CGGCGAAGTAGACTAAACG -> GGCGAAGTAGACTAAACGA
CGGCTCAGGTCCTTAAACG -> GGCTCAGGTCCTTAAACGG
CGGCTGCTAGAGGACGCCT -> GGCTGCTAGAGGACGCCTG
CGGCTTCCACCCACGTGAT -> GGCTTCCACCCACGTGATG
CGGGACCCTAAATACGACT -> GGGACCCTAAATACGACTT
CGGGAGATCTATGAATAAC -> GGGAGATCTATGAATAACA
CGGGAGGCCCATGCTTCCG -> GGGAGGCCCATGCTTCCGA
CGGGCGAACCCCTGCGTCG -> GGGCGAACCCCTGCGTCGG
CGGGCGATGAGATTATACC -> GGGCGATGAGATTATACCG
CGGGGAAAGTGGTAAATTC -> GGGGAAAGTGGTAAATTCA
CGGGGACCAGGTGAGCAGA -> GGGGACCAGGTGAGCAGAT
CGGGGAGGTGTGGCATAGG -> GGGGAGGTGTGGCATAGGC
CGGGGTGAGCGATCGTCAA -> GGGGTGAGCGATCGTCAAG
CGGTAGTTTACATATCAGG -> GGTAGTTTACATATCAGGT
CGGTATAGGTTAAGCCTCG -> GGTATAGGTTAAGCCTCGC
CGGTCCTAACCACAGGCTC -> GGTCCTAACCACAGGCTCG
CGGTTTACTAGGCCTGGGC -> GGTTTACTAGGCCTGGGCT
CGGTTTTAGGCGAATTTTA -> GGTTTTAGGCGAATTTTAG
CGTACCCCTGTACCTGACT -> GTACCCCTGTACCTGACTC
CGTACTTACATGGTCCGAG -> GTACTTACATGGTCCGAGC
CGTAGAGTCCGCTTGTTGG -> GTAGAGTCCGCTTGTTGGC
CGTAGGAATTCGCCCTTGC -> GTAGGAATTCGCCCTTGCG
CGTATTACGAGTGCATGCG -> GTATTACGAGTGCATGCGT
CGTCAAGTCCGAAACCTTC -> GTCAAGTCCGAAACCTTCA
CGTCAGACCTTCGAACTAT -> GTCAGACCTTCGAACTATT
CGTCCTCCTTACCTCTCAG -> GTCCTCCTTACCTCTCAGG
CGTCGGTTTTAGGCGAATT -> GTCGGTTTTAGGCGAATTT
CGTGAACGTGCGGAGTTGG -> GTGAACGTGCGGAGTTGGG
CGTGAATCGAACTATTATG -> GTGAATCGAACTATTATGT
CGTGAGTATAAGCCGCAAT -> GTGAGTATAAGCCGCAATA
CGTGATGACTTGGAACTGC -> GTGATGACTTGGAACTGCT
CGTGCAACCTTTTAGTTAT -> GTGCAACCTTTTAGTTATG
CGTGCGAGCAAATGTGCGC -> GTGCGAGCAAATGTGCGCA
CGTGCGGAGTTGGGGCACA -> GTGCGGAGTTGGGGCACAA
CGTGGGCGGGGACCAGGTG -> GTGGGCGGGGACCAGGTGA
CGTTCCTCGGACTAGGCGA -> GTTCCTCGGACTAGGCGAA
CGTTCTATGCGGGCGATGA -> GTTCTATGCGGGCGATGAG
CGTTGCAATTCGGCCAAAT -> GTTGCAATTCGGCCAAATA
CGTTGTTTCCGCGCTAATC -> GTTGTTTCCGCGCTAATCA
CGTTTTATCGCGACGCAAT -> GTTTTATCGCGACGCAATT
CGTTTTGCGTTCTATGCGG -> GTTTTGCGTTCTATGCGGG
CTAAACGAAGCAGTGGACA -> TAAACGAAGCAGTGGACAA
CTAAAGGTGGGTAGAAACC -> TAAAGGTGGGTAGAAACCA
CTAAATACGACTTTAGAGG -> TAAATACGACTTTAGAGGA
CTAACCACAGGCTCGGCTG -> TAACCACAGGCTCGGCTGC
CTAACGACCAATTCGAATC -> TAACGACCAATTCGAATCT
CTAACGAGATCGCCAGAGG -> TAACGAGATCGCCAGAGGT
CTAATCACCAAAATCTCTA -> TAATCACCAAAATCTCTAG
CTAATTTCCCGGAACTGGA -> TAATTTCCCGGAACTGGAA
CTACAATGGTACGCAGCGA -> TACAATGGTACGCAGCGAA
CTACCGGGGAAAGTGGTAA -> TACCGGGGAAAGTGGTAAA
CTACCTTACACCAAAATGC -> TACCTTACACCAAAATGCT
CTACGCAGAGTGAGCAATC -> TACGCAGAGTGAGCAATCT
CTACGCGCAATGTGCGCCA -> TACGCGCAATGTGCGCCAC
CTACGGAGCAGTCAGCTAC -> TACGGAGCAGTCAGCTACT
CTACGTACCCCTGTACCTG -> TACGTACCCCTGTACCTGA
CTACGTGCGAGCAAATGTG -> TACGTGCGAGCAAATGTGC
CTACTACCTTACACCAAAA -> TACTACCTTACACCAAAAT
CTACTACGCAGAGTGAGCA -> TACTACGCAGAGTGAGCAA
CTACTTCCAGCGTGAACGT -> TACTTCCAGCGTGAACGTG
CTAGAGGACGCCTGTACGC -> TAGAGGACGCCTGTACGCC
CTAGAGGAGGTCTACCGGG -> TAGAGGAGGTCTACCGGGG
CTAGATATGACATTAACGT -> TAGATATGACATTAACGTT
CTAGCCTCAGACCTATGTC -> TAGCCTCAGACCTATGTCG
CTAGGCCTGGGCTCGCAAG -> TAGGCCTGGGCTCGCAAGT
CTAGGCGAATTTTAGGAAG -> TAGGCGAATTTTAGGAAGC
CTATAACGAACTATTATGT -> TATAACGAACTATTATGTT
CTATAATTTGGCCTTGCCA -> TATAATTTGGCCTTGCCAA
CTATACCAGTCGGGAGATC -> TATACCAGTCGGGAGATCT
CTATAGGCGAAAATCGACA -> TATAGGCGAAAATCGACAT
CTATCTCATCGATAAATAG -> TATCTCATCGATAAATAGG
CTATCTGACGACTAGCCTC -> TATCTGACGACTAGCCTCA
CTATCTGTCTGTGACTACG -> TATCTGTCTGTGACTACGC
CTATGAATAACATGGTTAT -> TATGAATAACATGGTTATC
CTATGCGGGCGATGAGATT -> TATGCGGGCGATGAGATTA
CTATGTCGATCCGGAAAAT -> TATGTCGATCCGGAAAATC
CTATTATGTTGGAGTGGTT -> TATTATGTTGGAGTGGTTC
CTATTATGTTGGAGTGTAC -> TATTATGTTGGAGTGTACG
CTATTATGTTGGAGTGTGT -> TATTATGTTGGAGTGTGTG
CTATTATGTTGGAGTTATG -> TATTATGTTGGAGTTATGA
CTCAAAAATCGTAGGAATT -> TCAAAAATCGTAGGAATTC
CTCACATTCGTTGCAATTC -> TCACATTCGTTGCAATTCG
CTCAGAATGTGAACTAACG -> TCAGAATGTGAACTAACGA
CTCAGACCTATGTCGATCC -> TCAGACCTATGTCGATCCG
CTCAGCATGTGCATATAAC -> TCAGCATGTGCATATAACC
CTCAGCTTTACCACACAGG -> TCAGCTTTACCACACAGGA
CTCAGGTATGATTAATATT -> TCAGGTATGATTAATATTG
CTCAGGTCCTTAAACGGTC -> TCAGGTCCTTAAACGGTCC
CTCAGGTGAGATCTATAGG -> TCAGGTGAGATCTATAGGC
CTCAGTTCGGAAAGTCATG -> TCAGTTCGGAAAGTCATGT
CTCATCGATAAATAGGTGA -> TCATCGATAAATAGGTGAA
CTCCCGCCTCTGGAGTGGA -> TCCCGCCTCTGGAGTGGAT
CTCCCTGCAGGACGTATTA -> TCCCTGCAGGACGTATTAC
CTCCTTACCTCTCAGGTAT -> TCCTTACCTCTCAGGTATG
CTCGAGCGATCGTTGTTTC -> TCGAGCGATCGTTGTTTCC
CTCGCAAGTGTCCGGAGAC -> TCGCAAGTGTCCGGAGACG
CTCGCATCTAGATATGACA -> TCGCATCTAGATATGACAT
CTCGCATGATAAGTTCAAG -> TCGCATGATAAGTTCAAGC
CTCGCGACAAGCACTACGG -> TCGCGACAAGCACTACGGA
CTCGCGCAGCCATCTATCT -> TCGCGCAGCCATCTATCTC
CTCGGACTAGGCGAATTTT -> TCGGACTAGGCGAATTTTA
CTCGGCTGCTAGAGGACGC -> TCGGCTGCTAGAGGACGCC
CTCGGGACCCTAAATACGA -> TCGGGACCCTAAATACGAC
CTCTAGAGGAGGTCTACCG -> TCTAGAGGAGGTCTACCGG
CTCTCAGGTATGATTAATA -> TCTCAGGTATGATTAATAT
CTCTGACGAACTCTTTGGT -> TCTGACGAACTCTTTGGTC
CTCTGATCTTCGATCTCAA -> TCTGATCTTCGATCTCAAA
CTCTGGAGTGGATCCTAAA -> TCTGGAGTGGATCCTAAAG
CTCTTTGGTCCTTGAGGTC -> TCTTTGGTCCTTGAGGTCG
CTGACGAACTCTTTGGTCC -> TGACGAACTCTTTGGTCCT
CTGACGACTAGCCTCAGAC -> TGACGACTAGCCTCAGACC
CTGACTCGCGACAAGCACT -> TGACTCGCGACAAGCACTA
CTGATCTTCGATCTCAAAA -> TGATCTTCGATCTCAAAAA
CTGCAGGACGTATTACGAG -> TGCAGGACGTATTACGAGT
CTGCCTCCCGCCTCTGGAG -> TGCCTCCCGCCTCTGGAGT
CTGCGAAGATTAGAGGGAC -> TGCGAAGATTAGAGGGACG
CTGCGTACTTACATGGTCC -> TGCGTACTTACATGGTCCG
CTGCGTCGGTTTTAGGCGA -> TGCGTCGGTTTTAGGCGAA
CTGCTAGAGGACGCCTGTA -> TGCTAGAGGACGCCTGTAC
CTGCTTGTCTACGTACCCC -> TGCTTGTCTACGTACCCCT
CTGCTTTACCTTTTATGTG -> TGCTTTACCTTTTATGTGC
CTGGAAATCGGTATAGGTT -> TGGAAATCGGTATAGGTTA
CTGGAGTGGATCCTAAAGG -> TGGAGTGGATCCTAAAGGT
CTGGATCGATGTCCTTGGT -> TGGATCGATGTCCTTGGTT
CTGGCTATCTGACGACTAG -> TGGCTATCTGACGACTAGC
CTGGGAAAATGCGGCGAAG -> TGGGAAAATGCGGCGAAGT
CTGGGAGACATTATCTTTT -> TGGGAGACATTATCTTTTT
CTGGGCAGCACAAATTACC -> TGGGCAGCACAAATTACCT
CTGGGCTCGCAAGTGTCCG -> TGGGCTCGCAAGTGTCCGG
CTGGGGTTATACAGGTTCG -> TGGGGTTATACAGGTTCGA
CTGGTAGGCGAATTTTAGG -> TGGTAGGCGAATTTTAGGA
CTGGTCGGGCGAACCCCTG -> TGGTCGGGCGAACCCCTGC
CTGTACCCCAAAAGCCCGA -> TGTACCCCAAAAGCCCGAA
CTGTACCTGACTCGCGACA -> TGTACCTGACTCGCGACAA
CTGTACGCCTACTTCCAGC -> TGTACGCCTACTTCCAGCG
CTGTATGTCGGCTCAGGTC -> TGTATGTCGGCTCAGGTCC
CTGTCTGTGACTACGCGCA -> TGTCTGTGACTACGCGCAA
CTGTGACTACGCGCAATGT -> TGTGACTACGCGCAATGTG
CTGTGCTGGTAGGCGAATT -> TGTGCTGGTAGGCGAATTT
CTGTGGTGCGAACTGGTCG -> TGTGGTGCGAACTGGTCGG
CTTAAACGGTCCTAACCAC -> TTAAACGGTCCTAACCACA
CTTACACCAAAATGCTAAC -> TTACACCAAAATGCTAACG
CTTACATGGTCCGAGCTGG -> TTACATGGTCCGAGCTGGG
CTTACCCAATATTCTTCGG -> TTACCCAATATTCTTCGGT
CTTACCTCTCAGGTATGAT -> TTACCTCTCAGGTATGATT
CTTAGGCATATCTGCGTAC -> TTAGGCATATCTGCGTACT
CTTCAGTCCCCGAACCTCT -> TTCAGTCCCCGAACCTCTG
CTTCCACCCACGTGATGAC -> TTCCACCCACGTGATGACT
CTTCCAGCGTGAACGTGCG -> TTCCAGCGTGAACGTGCGG
CTTCCGACCAGCGACAAAG -> TTCCGACCAGCGACAAAGG
CTTCGAACTATTATGTTGG -> TTCGAACTATTATGTTGGA
CTTCGATCTCAAAAATCGT -> TTCGATCTCAAAAATCGTA
CTTCGGTTTACTAGGCCTG -> TTCGGTTTACTAGGCCTGG
CTTCGTGAATCGAACTATT -> TTCGTGAATCGAACTATTA
CTTGACAAATGTCTCAGCA -> TTGACAAATGTCTCAGCAT
CTTGAGGTCGCATAACCCG -> TTGAGGTCGCATAACCCGA
CTTGATATAGTAGATTTGT -> TTGATATAGTAGATTTGTC
CTTGCCAACTTAGGCATAT -> TTGCCAACTTAGGCATATC
CTTGCCGGTAGTTTACATA -> TTGCCGGTAGTTTACATAT
CTTGCGACTGTATGTCGGC -> TTGCGACTGTATGTCGGCT
CTTGGAACTGCTTGTCTAC -> TTGGAACTGCTTGTCTACG
CTTGGATCACTTGACAAAT -> TTGGATCACTTGACAAATG
CTTGGTTAGAGCCCTCGGG -> TTGGTTAGAGCCCTCGGGA
CTTGTCACACTCGCATGAT -> TTGTCACACTCGCATGATA
CTTGTCATTTCTACAATGG -> TTGTCATTTCTACAATGGT
CTTGTCTACGTACCCCTGT -> TTGTCTACGTACCCCTGTA
CTTGTTGGCTCGAGCGATC -> TTGTTGGCTCGAGCGATCG
CTTTACCACACAGGAAGCC -> TTTACCACACAGGAAGCCA
CTTTACCTTTTATGTGCGC -> TTTACCTTTTATGTGCGCT
CTTTAGAGGACAACCTTGA -> TTTAGAGGACAACCTTGAT
CTTTAGGTCCACCCGGGAG -> TTTAGGTCCACCCGGGAGG
CTTTATAGTGGTCGTGAGT -> TTTATAGTGGTCGTGAGTA
CTTTGGTCCTTGAGGTCGC -> TTTGGTCCTTGAGGTCGCA
CTTTTACTGCCTCCCGCCT -> TTTTACTGCCTCCCGCCTC
CTTTTAGTTATGCCGCAGA -> TTTTAGTTATGCCGCAGAG
CTTTTATGTGCGCTCACAT -> TTTTATGTGCGCTCACATT
CTTTTTGAAATCTGGGGTT -> TTTTTGAAATCTGGGGTTA
GAAAATCAGCTTGTCACAC -> AAAATCAGCTTGTCACACT
GAAAATCGACATGAGACTT -> AAAATCGACATGAGACTTA
GAAAATGCGGCGAAGTAGA -> AAAATGCGGCGAAGTAGAC
GAAACCAGTCCACTTTATA -> AAACCAGTCCACTTTATAG
GAAACCTTCAGTCCCCGAA -> AAACCTTCAGTCCCCGAAC
GAAACTGGATCGATGTCCT -> AAACTGGATCGATGTCCTT
GAAAGGGCCGTCCTCCTTA -> AAAGGGCCGTCCTCCTTAC
GAAAGTCATGTGCTGGCTA -> AAAGTCATGTGCTGGCTAT
GAAAGTGGTAAATTCAGCT -> AAAGTGGTAAATTCAGCTG
GAAATCGGTATAGGTTAAG -> AAATCGGTATAGGTTAAGC
GAAATCTGCGAAGATTAGA -> AAATCTGCGAAGATTAGAG
GAAATCTGGGGTTATACAG -> AAATCTGGGGTTATACAGG
GAACAGCAATCACAGGTGC -> AACAGCAATCACAGGTGCA
GAACCCCTGCGTCGGTTTT -> AACCCCTGCGTCGGTTTTA
GAACCTCTGATCTTCGATC -> AACCTCTGATCTTCGATCT
GAACGTGCGGAGTTGGGGC -> AACGTGCGGAGTTGGGGCA
GAACTAACGACCAATTCGA -> AACTAACGACCAATTCGAA
GAACTATTATGTTGGAGTG -> AACTATTATGTTGGAGTGG,AACTATTATGTTGGAGTGT,AACTATTATGTTGGAGTGT
GAACTATTATGTTGGAGTT -> AACTATTATGTTGGAGTTA
GAACTCTTTGGTCCTTGAG -> AACTCTTTGGTCCTTGAGG
GAACTGCTTGTCTACGTAC -> AACTGCTTGTCTACGTACC
GAACTGGAAATCGGTATAG -> AACTGGAAATCGGTATAGG
GAACTGGTCGGGCGAACCC -> AACTGGTCGGGCGAACCCC
GAAGACTGGGCAGCACAAA -> AAGACTGGGCAGCACAAAT
GAAGACTTCGTGAATCGAA -> AAGACTTCGTGAATCGAAC
GAAGATTAGAGGGACGCTA -> AAGATTAGAGGGACGCTAT
GAAGCAGTGGACAAAACCA -> AAGCAGTGGACAAAACCAA
GAAGCCATCTGTACCCCAA -> AAGCCATCTGTACCCCAAA
GAAGCCGCGAACAGCAATC -> AAGCCGCGAACAGCAATCA
GAAGCGTCAGACCTTCGAA -> AAGCGTCAGACCTTCGAAC
GAAGGGTTGACGGGGAGGT -> AAGGGTTGACGGGGAGGTG
GAAGGTAAGATTGGACGAA -> AAGGTAAGATTGGACGAAC
GAAGTAGACTAAACGAAGC -> AAGTAGACTAAACGAAGCA
GAAGTTACCCTATAACGAA -> AAGTTACCCTATAACGAAC
GAATAACATGGTTATCTCT -> AATAACATGGTTATCTCTG
GAATCAAAGATGGTAACTT -> AATCAAAGATGGTAACTTG
GAATCCGTTTTGCGTTCTA -> AATCCGTTTTGCGTTCTAT
GAATCGAACTATTATGTTG -> AATCGAACTATTATGTTGG
GAATCTGCTTTACCTTTTA -> AATCTGCTTTACCTTTTAT
GAATGACGCAAGACGATGA -> AATGACGCAAGACGATGAG
GAATGTGAACTAACGACCA -> AATGTGAACTAACGACCAA
GAATTCGCCCTTGCGACTG -> AATTCGCCCTTGCGACTGT
GAATTTTAGGAAGACTTCG -> AATTTTAGGAAGACTTCGT
GAATTTTAGGAAGCGTCAG -> AATTTTAGGAAGCGTCAGA
GAATTTTAGGAAGGTAAGA -> AATTTTAGGAAGGTAAGAT
GAATTTTAGGAAGTTACCC -> AATTTTAGGAAGTTACCCT
GACAAAACCAACCATCTTT -> ACAAAACCAACCATCTTTA
GACAAAGGACCACAGGCTG -> ACAAAGGACCACAGGCTGG
GACAAATGTCTCAGCATGT -> ACAAATGTCTCAGCATGTG
GACAACCTTGATATAGTAG -> ACAACCTTGATATAGTAGA
GACAAGCACTACGGAGCAG -> ACAAGCACTACGGAGCAGT
GACATGAGACTTACCCAAT -> ACATGAGACTTACCCAATA
GACATTAACGTTTTATCGC -> ACATTAACGTTTTATCGCG
GACATTATCTTTTTGAAAT -> ACATTATCTTTTTGAAATC
GACCAATTCGAATCTGCTT -> ACCAATTCGAATCTGCTTT
GACCACAGGCTGGGAGACA -> ACCACAGGCTGGGAGACAT
GACCAGCGACAAAGGACCA -> ACCAGCGACAAAGGACCAC
GACCAGGTGAGCAGATCAA -> ACCAGGTGAGCAGATCAAT
GACCCTAAATACGACTTTA -> ACCCTAAATACGACTTTAG
GACCTACGTGCGAGCAAAT -> ACCTACGTGCGAGCAAATG
GACCTATGTCGATCCGGAA -> ACCTATGTCGATCCGGAAA
GACCTTCGAACTATTATGT -> ACCTTCGAACTATTATGTT
GACGAACTATTATGTTGGA -> ACGAACTATTATGTTGGAG
GACGAACTCTTTGGTCCTT -> ACGAACTCTTTGGTCCTTG
GACGACTAGCCTCAGACCT -> ACGACTAGCCTCAGACCTA
GACGATGAGCCGGCCCGCG -> ACGATGAGCCGGCCCGCGG
GACGCAAGACGATGAGCCG -> ACGCAAGACGATGAGCCGG
GACGCAATTGGTAGAGTAA -> ACGCAATTGGTAGAGTAAT
GACGCCGGATAGACGGAAT -> ACGCCGGATAGACGGAATC
GACGCCTGTACGCCTACTT -> ACGCCTGTACGCCTACTTC
GACGCTATACCAGTCGGGA -> ACGCTATACCAGTCGGGAG
GACGGAATCAAAGATGGTA -> ACGGAATCAAAGATGGTAA
GACGGGGAGGTGTGGCATA -> ACGGGGAGGTGTGGCATAG
GACGTAGAGTCCGCTTGTT -> ACGTAGAGTCCGCTTGTTG
GACGTATTACGAGTGCATG -> ACGTATTACGAGTGCATGC
GACTAAACGAAGCAGTGGA -> ACTAAACGAAGCAGTGGAC
GACTAATTTCCCGGAACTG -> ACTAATTTCCCGGAACTGG
GACTACGCGCAATGTGCGC -> ACTACGCGCAATGTGCGCC
GACTAGCCTCAGACCTATG -> ACTAGCCTCAGACCTATGT
GACTAGGCGAATTTTAGGA -> ACTAGGCGAATTTTAGGAA
GACTCAGAATGTGAACTAA -> ACTCAGAATGTGAACTAAC
GACTCGCGACAAGCACTAC -> ACTCGCGACAAGCACTACG
GACTGGGCAGCACAAATTA -> ACTGGGCAGCACAAATTAC
GACTGTATGTCGGCTCAGG -> ACTGTATGTCGGCTCAGGT
GACTTACCCAATATTCTTC -> ACTTACCCAATATTCTTCG
GACTTCGTGAATCGAACTA -> ACTTCGTGAATCGAACTAT
GACTTGGAACTGCTTGTCT -> ACTTGGAACTGCTTGTCTA
GACTTTAGAGGACAACCTT -> ACTTTAGAGGACAACCTTG
GAGACATTATCTTTTTGAA -> AGACATTATCTTTTTGAAA
GAGACGTAGAGTCCGCTTG -> AGACGTAGAGTCCGCTTGT
GAGACTTACCCAATATTCT -> AGACTTACCCAATATTCTT
GAGAGGGTCAGACGCCGGA -> AGAGGGTCAGACGCCGGAT
GAGATCGCCAGAGGTGGTG -> AGATCGCCAGAGGTGGTGT
GAGATCTATAGGCGAAAAT -> AGATCTATAGGCGAAAATC
GAGATCTATGAATAACATG -> AGATCTATGAATAACATGG
GAGATTATACCGTGGGCGG -> AGATTATACCGTGGGCGGG
GAGCAAATGTGCGCAATTA -> AGCAAATGTGCGCAATTAG
GAGCAATCTTTTACTGCCT -> AGCAATCTTTTACTGCCTC
GAGCAGATCAATAAGCGCA -> AGCAGATCAATAAGCGCAT
GAGCAGTCAGCTACTACGC -> AGCAGTCAGCTACTACGCA
GAGCATATATGAATTCGGC -> AGCATATATGAATTCGGCA
GAGCCCTCGGGACCCTAAA -> AGCCCTCGGGACCCTAAAT
GAGCCGGCCCGCGGAAATC -> AGCCGGCCCGCGGAAATCT
GAGCGATCGTCAAGTCCGA -> AGCGATCGTCAAGTCCGAA
GAGCGATCGTTGTTTCCGC -> AGCGATCGTTGTTTCCGCG
GAGCTGGGAAAATGCGGCG -> AGCTGGGAAAATGCGGCGA
GAGGACAACCTTGATATAG -> AGGACAACCTTGATATAGT
GAGGACGCCTGTACGCCTA -> AGGACGCCTGTACGCCTAC
GAGGAGGTCTACCGGGGAA -> AGGAGGTCTACCGGGGAAA
GAGGCCCATGCTTCCGACC -> AGGCCCATGCTTCCGACCA
GAGGGACGCTATACCAGTC -> AGGGACGCTATACCAGTCG
GAGGGGCGGCTTCCACCCA -> AGGGGCGGCTTCCACCCAC
GAGGGTCAGACGCCGGATA -> AGGGTCAGACGCCGGATAG
GAGGTCGCATAACCCGACC -> AGGTCGCATAACCCGACCT
GAGGTCTACCGGGGAAAGT -> AGGTCTACCGGGGAAAGTG
GAGGTGGTGTGTGAAAGGG -> AGGTGGTGTGTGAAAGGGC
GAGGTGTGGCATAGGCGAA -> AGGTGTGGCATAGGCGAAT
GAGGTTGGCTATCTGTCTG -> AGGTTGGCTATCTGTCTGT
GAGTAATGCTGTGCTGGTA -> AGTAATGCTGTGCTGGTAG
GAGTATAAGCCGCAATAGG -> AGTATAAGCCGCAATAGGG
GAGTCCGCTTGTTGGCTCG -> AGTCCGCTTGTTGGCTCGA
GAGTGAGCAATCTTTTACT -> AGTGAGCAATCTTTTACTG
GAGTGCATGCGTGCAACCT -> AGTGCATGCGTGCAACCTT
GAGTGGATCCTAAAGGTGG -> AGTGGATCCTAAAGGTGGG
GAGTGGTTCAACTCAGCTT -> AGTGGTTCAACTCAGCTTT
GAGTGTACGAGGTTGGCTA -> AGTGTACGAGGTTGGCTAT
GAGTGTGTCGACTCAGAAT -> AGTGTGTCGACTCAGAATG
GAGTGTGTGAGTGTGTCGA -> AGTGTGTGAGTGTGTCGAC
GAGTTATGAATCCGTTTTG -> AGTTATGAATCCGTTTTGC
GAGTTGGGGCACAATTATG -> AGTTGGGGCACAATTATGG
GATAAATAGGTGAAACTGG -> ATAAATAGGTGAAACTGGA
GATAAGTTCAAGCGGGGTG -> ATAAGTTCAAGCGGGGTGA
GATAGACGGAATCAAAGAT -> ATAGACGGAATCAAAGATG
GATATAGTAGATTTGTCTC -> ATATAGTAGATTTGTCTCA
GATATGACATTAACGTTTT -> ATATGACATTAACGTTTTA
GATCAATAAGCGCATTCTA -> ATCAATAAGCGCATTCTAC
GATCACTTGACAAATGTCT -> ATCACTTGACAAATGTCTC
GATCCGGAAAATCAGCTTG -> ATCCGGAAAATCAGCTTGT
GATCCTAAAGGTGGGTAGA -> ATCCTAAAGGTGGGTAGAA
GATCGATGTCCTTGGTTAG -> ATCGATGTCCTTGGTTAGA
GATCGCCAGAGGTGGTGTG -> ATCGCCAGAGGTGGTGTGT
GATCGTCAAGTCCGAAACC -> ATCGTCAAGTCCGAAACCT
GATCGTTGTTTCCGCGCTA -> ATCGTTGTTTCCGCGCTAA
GATCTATAGGCGAAAATCG -> ATCTATAGGCGAAAATCGA
GATCTATGAATAACATGGT -> ATCTATGAATAACATGGTT
GATCTCAAAAATCGTAGGA -> ATCTCAAAAATCGTAGGAA
GATCTCCCTGCAGGACGTA -> ATCTCCCTGCAGGACGTAT
GATCTTCGATCTCAAAAAT -> ATCTTCGATCTCAAAAATC
GATGACTTGGAACTGCTTG -> ATGACTTGGAACTGCTTGT
GATGAGATTATACCGTGGG -> ATGAGATTATACCGTGGGC
GATGAGCCGGCCCGCGGAA -> ATGAGCCGGCCCGCGGAAA
GATGCGAAGGGTTGACGGG -> ATGCGAAGGGTTGACGGGG
GATGGTAACTTGGATCACT -> ATGGTAACTTGGATCACTT
GATGTCCTTGGTTAGAGCC -> ATGTCCTTGGTTAGAGCCC
GATTAATATTGATCTCCCT -> ATTAATATTGATCTCCCTG
GATTAGAGGGACGCTATAC -> ATTAGAGGGACGCTATACC
GATTATACCGTGGGCGGGG -> ATTATACCGTGGGCGGGGA
GATTGGACGAACTATTATG -> ATTGGACGAACTATTATGT
GATTTGTCTCAGTTCGGAA -> ATTTGTCTCAGTTCGGAAA
GCAAATGTGCGCAATTAGT -> CAAATGTGCGCAATTAGTA
GCAACCTTTTAGTTATGCC -> CAACCTTTTAGTTATGCCG
GCAAGACGATGAGCCGGCC -> CAAGACGATGAGCCGGCCC
GCAAGTGTCCGGAGACGTA -> CAAGTGTCCGGAGACGTAG
GCAATAGGGATGCGAAGGG -> CAATAGGGATGCGAAGGGT
GCAATCACAGGTGCAATGT -> CAATCACAGGTGCAATGTC
GCAATCTTTTACTGCCTCC -> CAATCTTTTACTGCCTCCC
GCAATGTCGGCCCAGGCCC -> CAATGTCGGCCCAGGCCCA
GCAATGTGCGCCACAAGCC -> CAATGTGCGCCACAAGCCG
GCAATTAGTACAGCGACTA -> CAATTAGTACAGCGACTAA
GCAATTCGGCCAAATATTG -> CAATTCGGCCAAATATTGA
GCAATTGGTAGAGTAATGC -> CAATTGGTAGAGTAATGCT
GCACAAATTACCTATAATT -> CACAAATTACCTATAATTT
GCACAATTATGGCTTGTCA -> CACAATTATGGCTTGTCAT
GCACCCTCAGGTGAGATCT -> CACCCTCAGGTGAGATCTA
GCACTACGGAGCAGTCAGC -> CACTACGGAGCAGTCAGCT
GCAGAGAGGGTCAGACGCC -> CAGAGAGGGTCAGACGCCG
GCAGAGTGAGCAATCTTTT -> CAGAGTGAGCAATCTTTTA
GCAGATCAATAAGCGCATT -> CAGATCAATAAGCGCATTC
GCAGCACAAATTACCTATA -> CAGCACAAATTACCTATAA
GCAGCCATCTATCTCATCG -> CAGCCATCTATCTCATCGA
GCAGCGAAGCCGCGAACAG -> CAGCGAAGCCGCGAACAGC
GCAGGACGTATTACGAGTG -> CAGGACGTATTACGAGTGC
GCAGTCAGCTACTACGCAG -> CAGTCAGCTACTACGCAGA
GCAGTGGACAAAACCAACC -> CAGTGGACAAAACCAACCA
GCATAACCCGACCTACGTG -> CATAACCCGACCTACGTGC
GCATAGGCGAATTTTAGGA -> CATAGGCGAATTTTAGGAA
GCATATAACCTCGCATCTA -> CATATAACCTCGCATCTAG
GCATATCTGCGTACTTACA -> CATATCTGCGTACTTACAT
GCATCTAGATATGACATTA -> CATCTAGATATGACATTAA
GCATGATAAGTTCAAGCGG -> CATGATAAGTTCAAGCGGG
GCATGCGTGCAACCTTTTA -> CATGCGTGCAACCTTTTAG
GCATGTGCATATAACCTCG -> CATGTGCATATAACCTCGC
GCATTCTACTACCTTACAC -> CATTCTACTACCTTACACC
GCCAAATATTGAATGACGC -> CCAAATATTGAATGACGCA
GCCAACTTAGGCATATCTG -> CCAACTTAGGCATATCTGC
GCCACAAGCCGTTCCTCGG -> CCACAAGCCGTTCCTCGGA
GCCAGAGGTGGTGTGTGAA -> CCAGAGGTGGTGTGTGAAA
GCCATCTATCTCATCGATA -> CCATCTATCTCATCGATAA
GCCATCTGTACCCCAAAAG -> CCATCTGTACCCCAAAAGC
GCCCAGAGGGGCGGCTTCC -> CCCAGAGGGGCGGCTTCCA
GCCCAGGCCCAGAGGGGCG -> CCCAGGCCCAGAGGGGCGG
GCCCATGCTTCCGACCAGC -> CCCATGCTTCCGACCAGCG
GCCCGAAGACTGGGCAGCA -> CCCGAAGACTGGGCAGCAC
GCCCGCGGAAATCTGCGAA -> CCCGCGGAAATCTGCGAAG
GCCCTCGGGACCCTAAATA -> CCCTCGGGACCCTAAATAC
GCCCTTGCGACTGTATGTC -> CCCTTGCGACTGTATGTCG
GCCGCAATAGGGATGCGAA -> CCGCAATAGGGATGCGAAG
GCCGCAGAGAGGGTCAGAC -> CCGCAGAGAGGGTCAGACG
GCCGCGAACAGCAATCACA -> CCGCGAACAGCAATCACAG
GCCGGATAGACGGAATCAA -> CCGGATAGACGGAATCAAA
GCCGGCCCGCGGAAATCTG -> CCGGCCCGCGGAAATCTGC
GCCGGTAGTTTACATATCA -> CCGGTAGTTTACATATCAG
GCCGTCCTCCTTACCTCTC -> CCGTCCTCCTTACCTCTCA
GCCGTTCCTCGGACTAGGC -> CCGTTCCTCGGACTAGGCG
GCCTACTTCCAGCGTGAAC -> CCTACTTCCAGCGTGAACG
GCCTCAGACCTATGTCGAT -> CCTCAGACCTATGTCGATC
GCCTCCCGCCTCTGGAGTG -> CCTCCCGCCTCTGGAGTGG
GCCTCGCGCAGCCATCTAT -> CCTCGCGCAGCCATCTATC
GCCTCTGGAGTGGATCCTA -> CCTCTGGAGTGGATCCTAA
GCCTGGGCTCGCAAGTGTC -> CCTGGGCTCGCAAGTGTCC
GCCTGTACGCCTACTTCCA -> CCTGTACGCCTACTTCCAG
GCCTTGCCAACTTAGGCAT -> CCTTGCCAACTTAGGCATA
GCGAAAATCGACATGAGAC -> CGAAAATCGACATGAGACT
GCGAACAGCAATCACAGGT -> CGAACAGCAATCACAGGTG
GCGAACCCCTGCGTCGGTT -> CGAACCCCTGCGTCGGTTT
GCGAACTGGTCGGGCGAAC -> CGAACTGGTCGGGCGAACC
GCGAAGATTAGAGGGACGC -> CGAAGATTAGAGGGACGCT
GCGAAGCCGCGAACAGCAA -> CGAAGCCGCGAACAGCAAT
GCGAAGGGTTGACGGGGAG -> CGAAGGGTTGACGGGGAGG
GCGAAGTAGACTAAACGAA -> CGAAGTAGACTAAACGAAG
GCGAATTTTAGGAAGACTT -> CGAATTTTAGGAAGACTTC
GCGAATTTTAGGAAGCGTC -> CGAATTTTAGGAAGCGTCA
GCGAATTTTAGGAAGGTAA -> CGAATTTTAGGAAGGTAAG
GCGAATTTTAGGAAGTTAC -> CGAATTTTAGGAAGTTACC
GCGACAAAGGACCACAGGC -> CGACAAAGGACCACAGGCT
GCGACAAGCACTACGGAGC -> CGACAAGCACTACGGAGCA
GCGACGCAATTGGTAGAGT -> CGACGCAATTGGTAGAGTA
GCGACTAATTTCCCGGAAC -> CGACTAATTTCCCGGAACT
GCGACTGTATGTCGGCTCA -> CGACTGTATGTCGGCTCAG
GCGAGCAAATGTGCGCAAT -> CGAGCAAATGTGCGCAATT
GCGATCGTCAAGTCCGAAA -> CGATCGTCAAGTCCGAAAC
GCGATCGTTGTTTCCGCGC -> CGATCGTTGTTTCCGCGCT
GCGATGAGATTATACCGTG -> CGATGAGATTATACCGTGG
GCGCAATGTGCGCCACAAG -> CGCAATGTGCGCCACAAGC
GCGCAATTAGTACAGCGAC -> CGCAATTAGTACAGCGACT
GCGCAGCCATCTATCTCAT -> CGCAGCCATCTATCTCATC
GCGCATTCTACTACCTTAC -> CGCATTCTACTACCTTACA
GCGCCACAAGCCGTTCCTC -> CGCCACAAGCCGTTCCTCG
GCGCTAATCACCAAAATCT -> CGCTAATCACCAAAATCTC
GCGCTCACATTCGTTGCAA -> CGCTCACATTCGTTGCAAT
GCGGAAATCTGCGAAGATT -> CGGAAATCTGCGAAGATTA
GCGGAGTTGGGGCACAATT -> CGGAGTTGGGGCACAATTA
GCGGCGAAGTAGACTAAAC -> CGGCGAAGTAGACTAAACG
GCGGCTTCCACCCACGTGA -> CGGCTTCCACCCACGTGAT
GCGGGCGATGAGATTATAC -> CGGGCGATGAGATTATACC
GCGGGGACCAGGTGAGCAG -> CGGGGACCAGGTGAGCAGA
GCGGGGTGAGCGATCGTCA -> CGGGGTGAGCGATCGTCAA
GCGTACTTACATGGTCCGA -> CGTACTTACATGGTCCGAG
GCGTCAGACCTTCGAACTA -> CGTCAGACCTTCGAACTAT
GCGTCGGTTTTAGGCGAAT -> CGTCGGTTTTAGGCGAATT
GCGTGAACGTGCGGAGTTG -> CGTGAACGTGCGGAGTTGG
GCGTGCAACCTTTTAGTTA -> CGTGCAACCTTTTAGTTAT
GCGTTCTATGCGGGCGATG -> CGTTCTATGCGGGCGATGA
GCTAACGAGATCGCCAGAG -> CTAACGAGATCGCCAGAGG
GCTAATCACCAAAATCTCT -> CTAATCACCAAAATCTCTA
GCTACTACGCAGAGTGAGC -> CTACTACGCAGAGTGAGCA
GCTAGAGGACGCCTGTACG -> CTAGAGGACGCCTGTACGC
GCTATACCAGTCGGGAGAT -> CTATACCAGTCGGGAGATC
GCTATCTGACGACTAGCCT -> CTATCTGACGACTAGCCTC
GCTATCTGTCTGTGACTAC -> CTATCTGTCTGTGACTACG
GCTCACATTCGTTGCAATT -> CTCACATTCGTTGCAATTC
GCTCAGGTCCTTAAACGGT -> CTCAGGTCCTTAAACGGTC
GCTCGAGCGATCGTTGTTT -> CTCGAGCGATCGTTGTTTC
GCTCGCAAGTGTCCGGAGA -> CTCGCAAGTGTCCGGAGAC
GCTCGGCTGCTAGAGGACG -> CTCGGCTGCTAGAGGACGC
GCTGCTAGAGGACGCCTGT -> CTGCTAGAGGACGCCTGTA
GCTGGCTATCTGACGACTA -> CTGGCTATCTGACGACTAG
GCTGGGAAAATGCGGCGAA -> CTGGGAAAATGCGGCGAAG
GCTGGGAGACATTATCTTT -> CTGGGAGACATTATCTTTT
GCTGGTAGGCGAATTTTAG -> CTGGTAGGCGAATTTTAGG
GCTGTGCTGGTAGGCGAAT -> CTGTGCTGGTAGGCGAATT
GCTGTGGTGCGAACTGGTC -> CTGTGGTGCGAACTGGTCG
GCTTCCACCCACGTGATGA -> CTTCCACCCACGTGATGAC
GCTTCCGACCAGCGACAAA -> CTTCCGACCAGCGACAAAG
GCTTGTCACACTCGCATGA -> CTTGTCACACTCGCATGAT
GCTTGTCATTTCTACAATG -> CTTGTCATTTCTACAATGG
GCTTGTCTACGTACCCCTG -> CTTGTCTACGTACCCCTGT
GCTTGTTGGCTCGAGCGAT -> CTTGTTGGCTCGAGCGATC
GCTTTACCACACAGGAAGC -> CTTTACCACACAGGAAGCC
GCTTTACCTTTTATGTGCG -> CTTTACCTTTTATGTGCGC
GGAAAATCAGCTTGTCACA -> GAAAATCAGCTTGTCACAC
GGAAAATGCGGCGAAGTAG -> GAAAATGCGGCGAAGTAGA
GGAAAGTCATGTGCTGGCT -> GAAAGTCATGTGCTGGCTA
GGAAAGTGGTAAATTCAGC -> GAAAGTGGTAAATTCAGCT
GGAAATCGGTATAGGTTAA -> GAAATCGGTATAGGTTAAG
GGAAATCTGCGAAGATTAG -> GAAATCTGCGAAGATTAGA
GGAACTGCTTGTCTACGTA -> GAACTGCTTGTCTACGTAC
GGAACTGGAAATCGGTATA -> GAACTGGAAATCGGTATAG
GGAAGACTTCGTGAATCGA -> GAAGACTTCGTGAATCGAA
GGAAGCCATCTGTACCCCA -> GAAGCCATCTGTACCCCAA
GGAAGCGTCAGACCTTCGA -> GAAGCGTCAGACCTTCGAA
GGAAGGTAAGATTGGACGA -> GAAGGTAAGATTGGACGAA
GGAAGTTACCCTATAACGA -> GAAGTTACCCTATAACGAA
GGAATCAAAGATGGTAACT -> GAATCAAAGATGGTAACTT
GGAATTCGCCCTTGCGACT -> GAATTCGCCCTTGCGACTG
GGACAAAACCAACCATCTT -> GACAAAACCAACCATCTTT
GGACAACCTTGATATAGTA -> GACAACCTTGATATAGTAG
GGACCACAGGCTGGGAGAC -> GACCACAGGCTGGGAGACA
GGACCAGGTGAGCAGATCA -> GACCAGGTGAGCAGATCAA
GGACCCTAAATACGACTTT -> GACCCTAAATACGACTTTA
GGACGAACTATTATGTTGG -> GACGAACTATTATGTTGGA
GGACGCCTGTACGCCTACT -> GACGCCTGTACGCCTACTT
GGACGCTATACCAGTCGGG -> GACGCTATACCAGTCGGGA
GGACGTATTACGAGTGCAT -> GACGTATTACGAGTGCATG
GGACTAGGCGAATTTTAGG -> GACTAGGCGAATTTTAGGA
GGAGACATTATCTTTTTGA -> GAGACATTATCTTTTTGAA
GGAGACGTAGAGTCCGCTT -> GAGACGTAGAGTCCGCTTG
GGAGATCTATGAATAACAT -> GAGATCTATGAATAACATG
GGAGCAGTCAGCTACTACG -> GAGCAGTCAGCTACTACGC
GGAGGCCCATGCTTCCGAC -> GAGGCCCATGCTTCCGACC
GGAGGTCTACCGGGGAAAG -> GAGGTCTACCGGGGAAAGT
GGAGGTGTGGCATAGGCGA -> GAGGTGTGGCATAGGCGAA
GGAGTGGATCCTAAAGGTG -> GAGTGGATCCTAAAGGTGG
GGAGTGGTTCAACTCAGCT -> GAGTGGTTCAACTCAGCTT
GGAGTGTACGAGGTTGGCT -> GAGTGTACGAGGTTGGCTA
GGAGTGTGTGAGTGTGTCG -> GAGTGTGTGAGTGTGTCGA
GGAGTTATGAATCCGTTTT -> GAGTTATGAATCCGTTTTG
GGAGTTGGGGCACAATTAT -> GAGTTGGGGCACAATTATG
GGATAGACGGAATCAAAGA -> GATAGACGGAATCAAAGAT
GGATCACTTGACAAATGTC -> GATCACTTGACAAATGTCT
GGATCCTAAAGGTGGGTAG -> GATCCTAAAGGTGGGTAGA
GGATCGATGTCCTTGGTTA -> GATCGATGTCCTTGGTTAG
GGATGCGAAGGGTTGACGG -> GATGCGAAGGGTTGACGGG
GGCACAATTATGGCTTGTC -> GCACAATTATGGCTTGTCA
GGCAGCACAAATTACCTAT -> GCAGCACAAATTACCTATA
GGCATAGGCGAATTTTAGG -> GCATAGGCGAATTTTAGGA
GGCATATCTGCGTACTTAC -> GCATATCTGCGTACTTACA
GGCCAAATATTGAATGACG -> GCCAAATATTGAATGACGC
GGCCCAGAGGGGCGGCTTC -> GCCCAGAGGGGCGGCTTCC
GGCCCAGGCCCAGAGGGGC -> GCCCAGGCCCAGAGGGGCG
GGCCCATGCTTCCGACCAG -> GCCCATGCTTCCGACCAGC
GGCCCGCGGAAATCTGCGA -> GCCCGCGGAAATCTGCGAA
GGCCGTCCTCCTTACCTCT -> GCCGTCCTCCTTACCTCTC
GGCCTGGGCTCGCAAGTGT -> GCCTGGGCTCGCAAGTGTC
GGCCTTGCCAACTTAGGCA -> GCCTTGCCAACTTAGGCAT
GGCGAAAATCGACATGAGA -> GCGAAAATCGACATGAGAC
GGCGAACCCCTGCGTCGGT -> GCGAACCCCTGCGTCGGTT
GGCGAAGTAGACTAAACGA -> GCGAAGTAGACTAAACGAA
GGCGAATTTTAGGAAGACT -> GCGAATTTTAGGAAGACTT
GGCGAATTTTAGGAAGCGT -> GCGAATTTTAGGAAGCGTC
GGCGAATTTTAGGAAGGTA -> GCGAATTTTAGGAAGGTAA
GGCGAATTTTAGGAAGTTA -> GCGAATTTTAGGAAGTTAC
GGCGATGAGATTATACCGT -> GCGATGAGATTATACCGTG
GGCGGCTTCCACCCACGTG -> GCGGCTTCCACCCACGTGA
GGCGGGGACCAGGTGAGCA -> GCGGGGACCAGGTGAGCAG
GGCTATCTGACGACTAGCC -> GCTATCTGACGACTAGCCT
GGCTATCTGTCTGTGACTA -> GCTATCTGTCTGTGACTAC
GGCTCAGGTCCTTAAACGG -> GCTCAGGTCCTTAAACGGT
GGCTCGAGCGATCGTTGTT -> GCTCGAGCGATCGTTGTTT
GGCTCGCAAGTGTCCGGAG -> GCTCGCAAGTGTCCGGAGA
GGCTCGGCTGCTAGAGGAC -> GCTCGGCTGCTAGAGGACG
GGCTGCTAGAGGACGCCTG -> GCTGCTAGAGGACGCCTGT
GGCTGGGAGACATTATCTT -> GCTGGGAGACATTATCTTT
GGCTTCCACCCACGTGATG -> GCTTCCACCCACGTGATGA
GGCTTGTCATTTCTACAAT -> GCTTGTCATTTCTACAATG
GGGAAAATGCGGCGAAGTA -> GGAAAATGCGGCGAAGTAG
GGGAAAGTGGTAAATTCAG -> GGAAAGTGGTAAATTCAGC
GGGACCAGGTGAGCAGATC -> GGACCAGGTGAGCAGATCA
GGGACCCTAAATACGACTT -> GGACCCTAAATACGACTTT
GGGACGCTATACCAGTCGG -> GGACGCTATACCAGTCGGG
GGGAGACATTATCTTTTTG -> GGAGACATTATCTTTTTGA
GGGAGATCTATGAATAACA -> GGAGATCTATGAATAACAT
GGGAGGCCCATGCTTCCGA -> GGAGGCCCATGCTTCCGAC
GGGAGGTGTGGCATAGGCG -> GGAGGTGTGGCATAGGCGA
GGGATGCGAAGGGTTGACG -> GGATGCGAAGGGTTGACGG
GGGCACAATTATGGCTTGT -> GGCACAATTATGGCTTGTC
GGGCAGCACAAATTACCTA -> GGCAGCACAAATTACCTAT
GGGCCGTCCTCCTTACCTC -> GGCCGTCCTCCTTACCTCT
GGGCGAACCCCTGCGTCGG -> GGCGAACCCCTGCGTCGGT
GGGCGATGAGATTATACCG -> GGCGATGAGATTATACCGT
GGGCGGCTTCCACCCACGT -> GGCGGCTTCCACCCACGTG
GGGCGGGGACCAGGTGAGC -> GGCGGGGACCAGGTGAGCA
GGGCTCGCAAGTGTCCGGA -> GGCTCGCAAGTGTCCGGAG
GGGGAAAGTGGTAAATTCA -> GGGAAAGTGGTAAATTCAG
GGGGACCAGGTGAGCAGAT -> GGGACCAGGTGAGCAGATC
GGGGAGGTGTGGCATAGGC -> GGGAGGTGTGGCATAGGCG
GGGGCACAATTATGGCTTG -> GGGCACAATTATGGCTTGT
GGGGCGGCTTCCACCCACG -> GGGCGGCTTCCACCCACGT
GGGGTGAGCGATCGTCAAG -> GGGTGAGCGATCGTCAAGT
GGGGTTATACAGGTTCGAG -> GGGTTATACAGGTTCGAGC
GGGTAGAAACCAGTCCACT -> GGTAGAAACCAGTCCACTT
GGGTCAGACGCCGGATAGA -> GGTCAGACGCCGGATAGAC
GGGTGAGCGATCGTCAAGT -> GGTGAGCGATCGTCAAGTC
GGGTTATACAGGTTCGAGC -> GGTTATACAGGTTCGAGCA
GGGTTGACGGGGAGGTGTG -> GGTTGACGGGGAGGTGTGG
GGTAAATTCAGCTGTGGTG -> GTAAATTCAGCTGTGGTGC
GGTAACTTGGATCACTTGA -> GTAACTTGGATCACTTGAC
GGTAAGATTGGACGAACTA -> GTAAGATTGGACGAACTAT
GGTACGCAGCGAAGCCGCG -> GTACGCAGCGAAGCCGCGA
GGTAGAAACCAGTCCACTT -> GTAGAAACCAGTCCACTTT
GGTAGAGTAATGCTGTGCT -> GTAGAGTAATGCTGTGCTG
GGTAGGCGAATTTTAGGAA -> GTAGGCGAATTTTAGGAAG
GGTAGTTTACATATCAGGT -> GTAGTTTACATATCAGGTT
GGTATAGGTTAAGCCTCGC -> GTATAGGTTAAGCCTCGCG
GGTATGATTAATATTGATC -> GTATGATTAATATTGATCT
GGTCAGACGCCGGATAGAC -> GTCAGACGCCGGATAGACG
GGTCCACCCGGGAGGCCCA -> GTCCACCCGGGAGGCCCAT
GGTCCGAGCTGGGAAAATG -> GTCCGAGCTGGGAAAATGC
GGTCCTAACCACAGGCTCG -> GTCCTAACCACAGGCTCGG
GGTCCTTAAACGGTCCTAA -> GTCCTTAAACGGTCCTAAC
GGTCCTTGAGGTCGCATAA -> GTCCTTGAGGTCGCATAAC
GGTCGCATAACCCGACCTA -> GTCGCATAACCCGACCTAC
GGTCGGGCGAACCCCTGCG -> GTCGGGCGAACCCCTGCGT
GGTCGTGAGTATAAGCCGC -> GTCGTGAGTATAAGCCGCA
GGTCTACCGGGGAAAGTGG -> GTCTACCGGGGAAAGTGGT
GGTGAAACTGGATCGATGT -> GTGAAACTGGATCGATGTC
GGTGAGATCTATAGGCGAA -> GTGAGATCTATAGGCGAAA
GGTGAGCAGATCAATAAGC -> GTGAGCAGATCAATAAGCG
GGTGAGCGATCGTCAAGTC -> GTGAGCGATCGTCAAGTCC
GGTGCAATGTCGGCCCAGG -> GTGCAATGTCGGCCCAGGC
GGTGCGAACTGGTCGGGCG -> GTGCGAACTGGTCGGGCGA
GGTGGGTAGAAACCAGTCC -> GTGGGTAGAAACCAGTCCA
GGTGGTGTGTGAAAGGGCC -> GTGGTGTGTGAAAGGGCCG
GGTGTGGCATAGGCGAATT -> GTGTGGCATAGGCGAATTT
GGTGTGTGAAAGGGCCGTC -> GTGTGTGAAAGGGCCGTCC
GGTTAAGCCTCGCGCAGCC -> GTTAAGCCTCGCGCAGCCA
GGTTAGAGCCCTCGGGACC -> GTTAGAGCCCTCGGGACCC
GGTTAGCACCCTCAGGTGA -> GTTAGCACCCTCAGGTGAG
GGTTATACAGGTTCGAGCA -> GTTATACAGGTTCGAGCAT
GGTTATCTCTGACGAACTC -> GTTATCTCTGACGAACTCT
GGTTCAACTCAGCTTTACC -> GTTCAACTCAGCTTTACCA
GGTTCGAGCATATATGAAT -> GTTCGAGCATATATGAATT
GGTTGACGGGGAGGTGTGG -> GTTGACGGGGAGGTGTGGC
GGTTGGCTATCTGTCTGTG -> GTTGGCTATCTGTCTGTGA
GGTTTACTAGGCCTGGGCT -> GTTTACTAGGCCTGGGCTC
GGTTTTAGGCGAATTTTAG -> GTTTTAGGCGAATTTTAGG
GTAAATTCAGCTGTGGTGC -> TAAATTCAGCTGTGGTGCG
GTAACTTGGATCACTTGAC -> TAACTTGGATCACTTGACA
GTAAGATTGGACGAACTAT -> TAAGATTGGACGAACTATT
GTAATGCTGTGCTGGTAGG -> TAATGCTGTGCTGGTAGGC
GTACAGCGACTAATTTCCC -> TACAGCGACTAATTTCCCG
GTACCCCAAAAGCCCGAAG -> TACCCCAAAAGCCCGAAGA
GTACCCCTGTACCTGACTC -> TACCCCTGTACCTGACTCG
GTACCTGACTCGCGACAAG -> TACCTGACTCGCGACAAGC
GTACGAGGTTGGCTATCTG -> TACGAGGTTGGCTATCTGT
GTACGCAGCGAAGCCGCGA -> TACGCAGCGAAGCCGCGAA
GTACGCCTACTTCCAGCGT -> TACGCCTACTTCCAGCGTG
GTACTTACATGGTCCGAGC -> TACTTACATGGTCCGAGCT
GTAGAAACCAGTCCACTTT -> TAGAAACCAGTCCACTTTA
GTAGACTAAACGAAGCAGT -> TAGACTAAACGAAGCAGTG
GTAGAGTAATGCTGTGCTG -> TAGAGTAATGCTGTGCTGG
GTAGAGTCCGCTTGTTGGC -> TAGAGTCCGCTTGTTGGCT
GTAGATTTGTCTCAGTTCG -> TAGATTTGTCTCAGTTCGG
GTAGGAATTCGCCCTTGCG -> TAGGAATTCGCCCTTGCGA
GTAGGCGAATTTTAGGAAG -> TAGGCGAATTTTAGGAAGG
GTAGTTTACATATCAGGTT -> TAGTTTACATATCAGGTTA
GTATAAGCCGCAATAGGGA -> TATAAGCCGCAATAGGGAT
GTATAGGTTAAGCCTCGCG -> TATAGGTTAAGCCTCGCGC
GTATGATTAATATTGATCT -> TATGATTAATATTGATCTC
GTATGTCGGCTCAGGTCCT -> TATGTCGGCTCAGGTCCTT
GTATTACGAGTGCATGCGT -> TATTACGAGTGCATGCGTG
GTCAAGTCCGAAACCTTCA -> TCAAGTCCGAAACCTTCAG
GTCACACTCGCATGATAAG -> TCACACTCGCATGATAAGT
GTCAGACCTTCGAACTATT -> TCAGACCTTCGAACTATTA
GTCAGACGCCGGATAGACG -> TCAGACGCCGGATAGACGG
GTCAGCTACTACGCAGAGT -> TCAGCTACTACGCAGAGTG
GTCATGTGCTGGCTATCTG -> TCATGTGCTGGCTATCTGA
GTCATTTCTACAATGGTAC -> TCATTTCTACAATGGTACG
GTCCACCCGGGAGGCCCAT -> TCCACCCGGGAGGCCCATG
GTCCACTTTATAGTGGTCG -> TCCACTTTATAGTGGTCGT
GTCCCCGAACCTCTGATCT -> TCCCCGAACCTCTGATCTT
GTCCGAAACCTTCAGTCCC -> TCCGAAACCTTCAGTCCCC
GTCCGAGCTGGGAAAATGC -> TCCGAGCTGGGAAAATGCG
GTCCGCTTGTTGGCTCGAG -> TCCGCTTGTTGGCTCGAGC
GTCCGGAGACGTAGAGTCC -> TCCGGAGACGTAGAGTCCG
GTCCTAACCACAGGCTCGG -> TCCTAACCACAGGCTCGGC
GTCCTCCTTACCTCTCAGG -> TCCTCCTTACCTCTCAGGT
GTCCTTAAACGGTCCTAAC -> TCCTTAAACGGTCCTAACC
GTCCTTGAGGTCGCATAAC -> TCCTTGAGGTCGCATAACC
GTCCTTGGTTAGAGCCCTC -> TCCTTGGTTAGAGCCCTCG
GTCGACTCAGAATGTGAAC -> TCGACTCAGAATGTGAACT
GTCGATCCGGAAAATCAGC -> TCGATCCGGAAAATCAGCT
GTCGCATAACCCGACCTAC -> TCGCATAACCCGACCTACG
GTCGGCCCAGGCCCAGAGG -> TCGGCCCAGGCCCAGAGGG
GTCGGCTCAGGTCCTTAAA -> TCGGCTCAGGTCCTTAAAC
GTCGGGAGATCTATGAATA -> TCGGGAGATCTATGAATAA
GTCGGGCGAACCCCTGCGT -> TCGGGCGAACCCCTGCGTC
GTCGGTTTTAGGCGAATTT -> TCGGTTTTAGGCGAATTTT
GTCGTGAGTATAAGCCGCA -> TCGTGAGTATAAGCCGCAA
GTCTACCGGGGAAAGTGGT -> TCTACCGGGGAAAGTGGTA
GTCTACGTACCCCTGTACC -> TCTACGTACCCCTGTACCT
GTCTCAGCATGTGCATATA -> TCTCAGCATGTGCATATAA
GTCTCAGTTCGGAAAGTCA -> TCTCAGTTCGGAAAGTCAT
GTCTGTGACTACGCGCAAT -> TCTGTGACTACGCGCAATG
GTGAAACTGGATCGATGTC -> TGAAACTGGATCGATGTCC
GTGAAAGGGCCGTCCTCCT -> TGAAAGGGCCGTCCTCCTT
GTGAACGTGCGGAGTTGGG -> TGAACGTGCGGAGTTGGGG
GTGAACTAACGACCAATTC -> TGAACTAACGACCAATTCG
GTGAATCGAACTATTATGT -> TGAATCGAACTATTATGTT
GTGACTACGCGCAATGTGC -> TGACTACGCGCAATGTGCG
GTGAGATCTATAGGCGAAA -> TGAGATCTATAGGCGAAAA
GTGAGCAATCTTTTACTGC -> TGAGCAATCTTTTACTGCC
GTGAGCAGATCAATAAGCG -> TGAGCAGATCAATAAGCGC
GTGAGCGATCGTCAAGTCC -> TGAGCGATCGTCAAGTCCG
GTGAGTATAAGCCGCAATA -> TGAGTATAAGCCGCAATAG
GTGAGTGTGTCGACTCAGA -> TGAGTGTGTCGACTCAGAA
GTGATGACTTGGAACTGCT -> TGATGACTTGGAACTGCTT
GTGCAACCTTTTAGTTATG -> TGCAACCTTTTAGTTATGC
GTGCAATGTCGGCCCAGGC -> TGCAATGTCGGCCCAGGCC
GTGCATATAACCTCGCATC -> TGCATATAACCTCGCATCT
GTGCATGCGTGCAACCTTT -> TGCATGCGTGCAACCTTTT
GTGCGAACTGGTCGGGCGA -> TGCGAACTGGTCGGGCGAA
GTGCGAGCAAATGTGCGCA -> TGCGAGCAAATGTGCGCAA
GTGCGCAATTAGTACAGCG -> TGCGCAATTAGTACAGCGA
GTGCGCCACAAGCCGTTCC -> TGCGCCACAAGCCGTTCCT
GTGCGCTCACATTCGTTGC -> TGCGCTCACATTCGTTGCA
GTGCGGAGTTGGGGCACAA -> TGCGGAGTTGGGGCACAAT
GTGCTGGCTATCTGACGAC -> TGCTGGCTATCTGACGACT
GTGCTGGTAGGCGAATTTT -> TGCTGGTAGGCGAATTTTA
GTGGACAAAACCAACCATC -> TGGACAAAACCAACCATCT
GTGGATCCTAAAGGTGGGT -> TGGATCCTAAAGGTGGGTA
GTGGCATAGGCGAATTTTA -> TGGCATAGGCGAATTTTAG
GTGGGCGGGGACCAGGTGA -> TGGGCGGGGACCAGGTGAG
GTGGGTAGAAACCAGTCCA -> TGGGTAGAAACCAGTCCAC
GTGGTAAATTCAGCTGTGG -> TGGTAAATTCAGCTGTGGT
GTGGTCGTGAGTATAAGCC -> TGGTCGTGAGTATAAGCCG
GTGGTGCGAACTGGTCGGG -> TGGTGCGAACTGGTCGGGC
GTGGTGTGTGAAAGGGCCG -> TGGTGTGTGAAAGGGCCGT
GTGGTTCAACTCAGCTTTA -> TGGTTCAACTCAGCTTTAC
GTGTACGAGGTTGGCTATC -> TGTACGAGGTTGGCTATCT
GTGTCCGGAGACGTAGAGT -> TGTCCGGAGACGTAGAGTC
GTGTCGACTCAGAATGTGA -> TGTCGACTCAGAATGTGAA
GTGTGAAAGGGCCGTCCTC -> TGTGAAAGGGCCGTCCTCC
GTGTGAGTGTGTCGACTCA -> TGTGAGTGTGTCGACTCAG
GTGTGGCATAGGCGAATTT -> TGTGGCATAGGCGAATTTT
GTGTGTCGACTCAGAATGT -> TGTGTCGACTCAGAATGTG
GTGTGTGAAAGGGCCGTCC -> TGTGTGAAAGGGCCGTCCT
GTGTGTGAGTGTGTCGACT -> TGTGTGAGTGTGTCGACTC
GTTAAGCCTCGCGCAGCCA -> TTAAGCCTCGCGCAGCCAT
GTTACCCTATAACGAACTA -> TTACCCTATAACGAACTAT
GTTAGAGCCCTCGGGACCC -> TTAGAGCCCTCGGGACCCT
GTTAGCACCCTCAGGTGAG -> TTAGCACCCTCAGGTGAGA
GTTATACAGGTTCGAGCAT -> TTATACAGGTTCGAGCATA
GTTATCTCTGACGAACTCT -> TTATCTCTGACGAACTCTT
GTTATGAATCCGTTTTGCG -> TTATGAATCCGTTTTGCGT
GTTATGCCGCAGAGAGGGT -> TTATGCCGCAGAGAGGGTC
GTTCAACTCAGCTTTACCA -> TTCAACTCAGCTTTACCAC
GTTCAAGCGGGGTGAGCGA -> TTCAAGCGGGGTGAGCGAT
GTTCCTCGGACTAGGCGAA -> TTCCTCGGACTAGGCGAAT
GTTCGAGCATATATGAATT -> TTCGAGCATATATGAATTC
GTTCGGAAAGTCATGTGCT -> TTCGGAAAGTCATGTGCTG
GTTCTATGCGGGCGATGAG -> TTCTATGCGGGCGATGAGA
GTTGACGGGGAGGTGTGGC -> TTGACGGGGAGGTGTGGCA
GTTGCAATTCGGCCAAATA -> TTGCAATTCGGCCAAATAT
GTTGGAGTGGTTCAACTCA -> TTGGAGTGGTTCAACTCAG
GTTGGAGTGTACGAGGTTG -> TTGGAGTGTACGAGGTTGG
GTTGGAGTGTGTGAGTGTG -> TTGGAGTGTGTGAGTGTGT
GTTGGAGTTATGAATCCGT -> TTGGAGTTATGAATCCGTT
GTTGGCTATCTGTCTGTGA -> TTGGCTATCTGTCTGTGAC
GTTGGCTCGAGCGATCGTT -> TTGGCTCGAGCGATCGTTG
GTTGGGGCACAATTATGGC -> TTGGGGCACAATTATGGCT
GTTGTTTCCGCGCTAATCA -> TTGTTTCCGCGCTAATCAC
GTTTACATATCAGGTTAGC -> TTTACATATCAGGTTAGCA
GTTTACTAGGCCTGGGCTC -> TTTACTAGGCCTGGGCTCG
GTTTCCGCGCTAATCACCA -> TTTCCGCGCTAATCACCAA
GTTTTAGGCGAATTTTAGG -> TTTTAGGCGAATTTTAGGA
GTTTTATCGCGACGCAATT -> TTTTATCGCGACGCAATTG
GTTTTGCGTTCTATGCGGG -> TTTTGCGTTCTATGCGGGC
TAAACGAAGCAGTGGACAA -> AAACGAAGCAGTGGACAAA
TAAACGGTCCTAACCACAG -> AAACGGTCCTAACCACAGG
TAAAGGTGGGTAGAAACCA -> AAAGGTGGGTAGAAACCAG
TAAATACGACTTTAGAGGA -> AAATACGACTTTAGAGGAC
TAAATAGGTGAAACTGGAT -> AAATAGGTGAAACTGGATC
TAAATTCAGCTGTGGTGCG -> AAATTCAGCTGTGGTGCGA
TAACATGGTTATCTCTGAC -> AACATGGTTATCTCTGACG
TAACCACAGGCTCGGCTGC -> AACCACAGGCTCGGCTGCT
TAACCCGACCTACGTGCGA -> AACCCGACCTACGTGCGAG
TAACCTCGCATCTAGATAT -> AACCTCGCATCTAGATATG
TAACGAACTATTATGTTGG -> AACGAACTATTATGTTGGA
TAACGACCAATTCGAATCT -> AACGACCAATTCGAATCTG
TAACGAGATCGCCAGAGGT -> AACGAGATCGCCAGAGGTG
TAACGTTTTATCGCGACGC -> AACGTTTTATCGCGACGCA
TAACTTGGATCACTTGACA -> AACTTGGATCACTTGACAA
TAAGATTGGACGAACTATT -> AAGATTGGACGAACTATTA
TAAGCCGCAATAGGGATGC -> AAGCCGCAATAGGGATGCG
TAAGCCTCGCGCAGCCATC -> AAGCCTCGCGCAGCCATCT
TAAGCGCATTCTACTACCT -> AAGCGCATTCTACTACCTT
TAAGTTCAAGCGGGGTGAG -> AAGTTCAAGCGGGGTGAGC
TAATATTGATCTCCCTGCA -> AATATTGATCTCCCTGCAG
TAATCACCAAAATCTCTAG -> AATCACCAAAATCTCTAGA
TAATGCTGTGCTGGTAGGC -> AATGCTGTGCTGGTAGGCG
TAATTTCCCGGAACTGGAA -> AATTTCCCGGAACTGGAAA
TAATTTGGCCTTGCCAACT -> AATTTGGCCTTGCCAACTT
TACAATGGTACGCAGCGAA -> ACAATGGTACGCAGCGAAG
TACACCAAAATGCTAACGA -> ACACCAAAATGCTAACGAG
TACAGCGACTAATTTCCCG -> ACAGCGACTAATTTCCCGG
TACAGGTTCGAGCATATAT -> ACAGGTTCGAGCATATATG
TACATATCAGGTTAGCACC -> ACATATCAGGTTAGCACCC
TACATGGTCCGAGCTGGGA -> ACATGGTCCGAGCTGGGAA
TACCACACAGGAAGCCATC -> ACCACACAGGAAGCCATCT
TACCAGTCGGGAGATCTAT -> ACCAGTCGGGAGATCTATG
TACCCAATATTCTTCGGTT -> ACCCAATATTCTTCGGTTT
TACCCCAAAAGCCCGAAGA -> ACCCCAAAAGCCCGAAGAC
TACCCCTGTACCTGACTCG -> ACCCCTGTACCTGACTCGC
TACCCTATAACGAACTATT -> ACCCTATAACGAACTATTA
TACCGGGGAAAGTGGTAAA -> ACCGGGGAAAGTGGTAAAT
TACCGTGGGCGGGGACCAG -> ACCGTGGGCGGGGACCAGG
TACCTATAATTTGGCCTTG -> ACCTATAATTTGGCCTTGC
TACCTCTCAGGTATGATTA -> ACCTCTCAGGTATGATTAA
TACCTGACTCGCGACAAGC -> ACCTGACTCGCGACAAGCA
TACCTTACACCAAAATGCT -> ACCTTACACCAAAATGCTA
TACCTTTTATGTGCGCTCA -> ACCTTTTATGTGCGCTCAC
TACGACTTTAGAGGACAAC -> ACGACTTTAGAGGACAACC
TACGAGGTTGGCTATCTGT -> ACGAGGTTGGCTATCTGTC
TACGAGTGCATGCGTGCAA -> ACGAGTGCATGCGTGCAAC
TACGCAGAGTGAGCAATCT -> ACGCAGAGTGAGCAATCTT
TACGCAGCGAAGCCGCGAA -> ACGCAGCGAAGCCGCGAAC
TACGCCTACTTCCAGCGTG -> ACGCCTACTTCCAGCGTGA
TACGCGCAATGTGCGCCAC -> ACGCGCAATGTGCGCCACA
TACGGAGCAGTCAGCTACT -> ACGGAGCAGTCAGCTACTA
TACGTACCCCTGTACCTGA -> ACGTACCCCTGTACCTGAC
TACGTGCGAGCAAATGTGC -> ACGTGCGAGCAAATGTGCG
TACTACCTTACACCAAAAT -> ACTACCTTACACCAAAATG
TACTACGCAGAGTGAGCAA -> ACTACGCAGAGTGAGCAAT
TACTAGGCCTGGGCTCGCA -> ACTAGGCCTGGGCTCGCAA
TACTGCCTCCCGCCTCTGG -> ACTGCCTCCCGCCTCTGGA
TACTTACATGGTCCGAGCT -> ACTTACATGGTCCGAGCTG
TACTTCCAGCGTGAACGTG -> ACTTCCAGCGTGAACGTGC
TAGAAACCAGTCCACTTTA -> AGAAACCAGTCCACTTTAT
TAGACGGAATCAAAGATGG -> AGACGGAATCAAAGATGGT
TAGACTAAACGAAGCAGTG -> AGACTAAACGAAGCAGTGG
TAGAGCCCTCGGGACCCTA -> AGAGCCCTCGGGACCCTAA
TAGAGGACAACCTTGATAT -> AGAGGACAACCTTGATATA
TAGAGGACGCCTGTACGCC -> AGAGGACGCCTGTACGCCT
TAGAGGAGGTCTACCGGGG -> AGAGGAGGTCTACCGGGGA
TAGAGGGACGCTATACCAG -> AGAGGGACGCTATACCAGT
TAGAGTAATGCTGTGCTGG -> AGAGTAATGCTGTGCTGGT
TAGAGTCCGCTTGTTGGCT -> AGAGTCCGCTTGTTGGCTC
TAGATATGACATTAACGTT -> AGATATGACATTAACGTTT
TAGATTTGTCTCAGTTCGG -> AGATTTGTCTCAGTTCGGA
TAGCACCCTCAGGTGAGAT -> AGCACCCTCAGGTGAGATC
TAGCCTCAGACCTATGTCG -> AGCCTCAGACCTATGTCGA
TAGGAAGACTTCGTGAATC -> AGGAAGACTTCGTGAATCG
TAGGAAGCGTCAGACCTTC -> AGGAAGCGTCAGACCTTCG
TAGGAAGGTAAGATTGGAC -> AGGAAGGTAAGATTGGACG
TAGGAAGTTACCCTATAAC -> AGGAAGTTACCCTATAACG
TAGGAATTCGCCCTTGCGA -> AGGAATTCGCCCTTGCGAC
TAGGCATATCTGCGTACTT -> AGGCATATCTGCGTACTTA
TAGGCCTGGGCTCGCAAGT -> AGGCCTGGGCTCGCAAGTG
TAGGCGAAAATCGACATGA -> AGGCGAAAATCGACATGAG
TAGGCGAATTTTAGGAAGA -> AGGCGAATTTTAGGAAGAC
TAGGCGAATTTTAGGAAGC -> AGGCGAATTTTAGGAAGCG
TAGGCGAATTTTAGGAAGG -> AGGCGAATTTTAGGAAGGT
TAGGCGAATTTTAGGAAGT -> AGGCGAATTTTAGGAAGTT
TAGGGATGCGAAGGGTTGA -> AGGGATGCGAAGGGTTGAC
TAGGTCCACCCGGGAGGCC -> AGGTCCACCCGGGAGGCCC
TAGGTGAAACTGGATCGAT -> AGGTGAAACTGGATCGATG
TAGGTTAAGCCTCGCGCAG -> AGGTTAAGCCTCGCGCAGC
TAGTACAGCGACTAATTTC -> AGTACAGCGACTAATTTCC
TAGTAGATTTGTCTCAGTT -> AGTAGATTTGTCTCAGTTC
TAGTGGTCGTGAGTATAAG -> AGTGGTCGTGAGTATAAGC
TAGTTATGCCGCAGAGAGG -> AGTTATGCCGCAGAGAGGG
TAGTTTACATATCAGGTTA -> AGTTTACATATCAGGTTAG
TATAACCTCGCATCTAGAT -> ATAACCTCGCATCTAGATA
TATAACGAACTATTATGTT -> ATAACGAACTATTATGTTG
TATAAGCCGCAATAGGGAT -> ATAAGCCGCAATAGGGATG
TATAATTTGGCCTTGCCAA -> ATAATTTGGCCTTGCCAAC
TATACAGGTTCGAGCATAT -> ATACAGGTTCGAGCATATA
TATACCAGTCGGGAGATCT -> ATACCAGTCGGGAGATCTA
TATACCGTGGGCGGGGACC -> ATACCGTGGGCGGGGACCA
TATAGGCGAAAATCGACAT -> ATAGGCGAAAATCGACATG
TATAGGTTAAGCCTCGCGC -> ATAGGTTAAGCCTCGCGCA
TATAGTAGATTTGTCTCAG -> ATAGTAGATTTGTCTCAGT
TATAGTGGTCGTGAGTATA -> ATAGTGGTCGTGAGTATAA
TATCAGGTTAGCACCCTCA -> ATCAGGTTAGCACCCTCAG
TATCGCGACGCAATTGGTA -> ATCGCGACGCAATTGGTAG
TATCTCATCGATAAATAGG -> ATCTCATCGATAAATAGGT
TATCTCTGACGAACTCTTT -> ATCTCTGACGAACTCTTTG
TATCTGACGACTAGCCTCA -> ATCTGACGACTAGCCTCAG
TATCTGCGTACTTACATGG -> ATCTGCGTACTTACATGGT
TATCTGTCTGTGACTACGC -> ATCTGTCTGTGACTACGCG
TATCTTTTTGAAATCTGGG -> ATCTTTTTGAAATCTGGGG
TATGAATAACATGGTTATC -> ATGAATAACATGGTTATCT
TATGAATCCGTTTTGCGTT -> ATGAATCCGTTTTGCGTTC
TATGACATTAACGTTTTAT -> ATGACATTAACGTTTTATC
TATGATTAATATTGATCTC -> ATGATTAATATTGATCTCC
TATGCCGCAGAGAGGGTCA -> ATGCCGCAGAGAGGGTCAG
TATGCGGGCGATGAGATTA -> ATGCGGGCGATGAGATTAT
TATGGCTTGTCATTTCTAC -> ATGGCTTGTCATTTCTACA
TATGTCGATCCGGAAAATC -> ATGTCGATCCGGAAAATCA
TATGTCGGCTCAGGTCCTT -> ATGTCGGCTCAGGTCCTTA
TATGTGCGCTCACATTCGT -> ATGTGCGCTCACATTCGTT
TATGTTGGAGTGGTTCAAC -> ATGTTGGAGTGGTTCAACT
TATGTTGGAGTGTACGAGG -> ATGTTGGAGTGTACGAGGT
TATGTTGGAGTGTGTGAGT -> ATGTTGGAGTGTGTGAGTG
TATGTTGGAGTTATGAATC -> ATGTTGGAGTTATGAATCC
TATTACGAGTGCATGCGTG -> ATTACGAGTGCATGCGTGC
TATTATGTTGGAGTGGTTC -> ATTATGTTGGAGTGGTTCA
TATTATGTTGGAGTGTACG -> ATTATGTTGGAGTGTACGA
TATTATGTTGGAGTGTGTG -> ATTATGTTGGAGTGTGTGA
TATTATGTTGGAGTTATGA -> ATTATGTTGGAGTTATGAA
TATTCTTCGGTTTACTAGG -> ATTCTTCGGTTTACTAGGC
TATTGAATGACGCAAGACG -> ATTGAATGACGCAAGACGA
TATTGATCTCCCTGCAGGA -> ATTGATCTCCCTGCAGGAC
TCAAAAATCGTAGGAATTC -> CAAAAATCGTAGGAATTCG
TCAAAGATGGTAACTTGGA -> CAAAGATGGTAACTTGGAT
TCAACTCAGCTTTACCACA -> CAACTCAGCTTTACCACAC
TCAAGCGGGGTGAGCGATC -> CAAGCGGGGTGAGCGATCG
TCAAGTCCGAAACCTTCAG -> CAAGTCCGAAACCTTCAGT
TCAATAAGCGCATTCTACT -> CAATAAGCGCATTCTACTA
TCACACTCGCATGATAAGT -> CACACTCGCATGATAAGTT
TCACAGGTGCAATGTCGGC -> CACAGGTGCAATGTCGGCC
TCACATTCGTTGCAATTCG -> CACATTCGTTGCAATTCGG
TCACCAAAATCTCTAGAGG -> CACCAAAATCTCTAGAGGA
TCACTTGACAAATGTCTCA -> CACTTGACAAATGTCTCAG
TCAGAATGTGAACTAACGA -> CAGAATGTGAACTAACGAC
TCAGACCTATGTCGATCCG -> CAGACCTATGTCGATCCGG
TCAGACCTTCGAACTATTA -> CAGACCTTCGAACTATTAT
TCAGACGCCGGATAGACGG -> CAGACGCCGGATAGACGGA
TCAGCATGTGCATATAACC -> CAGCATGTGCATATAACCT
TCAGCTACTACGCAGAGTG -> CAGCTACTACGCAGAGTGA
TCAGCTGTGGTGCGAACTG -> CAGCTGTGGTGCGAACTGG
TCAGCTTGTCACACTCGCA -> CAGCTTGTCACACTCGCAT
TCAGCTTTACCACACAGGA -> CAGCTTTACCACACAGGAA
TCAGGTATGATTAATATTG -> CAGGTATGATTAATATTGA
TCAGGTCCTTAAACGGTCC -> CAGGTCCTTAAACGGTCCT
TCAGGTGAGATCTATAGGC -> CAGGTGAGATCTATAGGCG
TCAGGTTAGCACCCTCAGG -> CAGGTTAGCACCCTCAGGT
TCAGTCCCCGAACCTCTGA -> CAGTCCCCGAACCTCTGAT
TCAGTTCGGAAAGTCATGT -> CAGTTCGGAAAGTCATGTG
TCATCGATAAATAGGTGAA -> CATCGATAAATAGGTGAAA
TCATGTGCTGGCTATCTGA -> CATGTGCTGGCTATCTGAC
TCATTTCTACAATGGTACG -> CATTTCTACAATGGTACGC
TCCACCCACGTGATGACTT -> CCACCCACGTGATGACTTG
TCCACCCGGGAGGCCCATG -> CCACCCGGGAGGCCCATGC
TCCACTTTATAGTGGTCGT -> CCACTTTATAGTGGTCGTG
TCCAGCGTGAACGTGCGGA -> CCAGCGTGAACGTGCGGAG
TCCCCGAACCTCTGATCTT -> CCCCGAACCTCTGATCTTC
TCCCGCCTCTGGAGTGGAT -> CCCGCCTCTGGAGTGGATC
TCCCGGAACTGGAAATCGG -> CCCGGAACTGGAAATCGGT
TCCCTGCAGGACGTATTAC -> CCCTGCAGGACGTATTACG
TCCGAAACCTTCAGTCCCC -> CCGAAACCTTCAGTCCCCG
TCCGACCAGCGACAAAGGA -> CCGACCAGCGACAAAGGAC
TCCGAGCTGGGAAAATGCG -> CCGAGCTGGGAAAATGCGG
TCCGCGCTAATCACCAAAA -> CCGCGCTAATCACCAAAAT
TCCGCTTGTTGGCTCGAGC -> CCGCTTGTTGGCTCGAGCG
TCCGGAAAATCAGCTTGTC -> CCGGAAAATCAGCTTGTCA
TCCGGAGACGTAGAGTCCG -> CCGGAGACGTAGAGTCCGC
TCCGTTTTGCGTTCTATGC -> CCGTTTTGCGTTCTATGCG
TCCTAAAGGTGGGTAGAAA -> CCTAAAGGTGGGTAGAAAC
TCCTAACCACAGGCTCGGC -> CCTAACCACAGGCTCGGCT
TCCTCCTTACCTCTCAGGT -> CCTCCTTACCTCTCAGGTA
TCCTCGGACTAGGCGAATT -> CCTCGGACTAGGCGAATTT
TCCTTAAACGGTCCTAACC -> CCTTAAACGGTCCTAACCA
TCCTTACCTCTCAGGTATG -> CCTTACCTCTCAGGTATGA
TCCTTGAGGTCGCATAACC -> CCTTGAGGTCGCATAACCC
TCCTTGGTTAGAGCCCTCG -> CCTTGGTTAGAGCCCTCGG
TCGAACTATTATGTTGGAG -> CGAACTATTATGTTGGAGT,CGAACTATTATGTTGGAGT
TCGAATCTGCTTTACCTTT -> CGAATCTGCTTTACCTTTT
TCGACATGAGACTTACCCA -> CGACATGAGACTTACCCAA
TCGACTCAGAATGTGAACT -> CGACTCAGAATGTGAACTA
TCGAGCATATATGAATTCG -> CGAGCATATATGAATTCGG
TCGAGCGATCGTTGTTTCC -> CGAGCGATCGTTGTTTCCG
TCGATAAATAGGTGAAACT -> CGATAAATAGGTGAAACTG
TCGATCCGGAAAATCAGCT -> CGATCCGGAAAATCAGCTT
TCGATCTCAAAAATCGTAG -> CGATCTCAAAAATCGTAGG
TCGATGTCCTTGGTTAGAG -> CGATGTCCTTGGTTAGAGC
TCGCAAGTGTCCGGAGACG -> CGCAAGTGTCCGGAGACGT
TCGCATAACCCGACCTACG -> CGCATAACCCGACCTACGT
TCGCATCTAGATATGACAT -> CGCATCTAGATATGACATT
TCGCATGATAAGTTCAAGC -> CGCATGATAAGTTCAAGCG
TCGCCAGAGGTGGTGTGTG -> CGCCAGAGGTGGTGTGTGA
TCGCCCTTGCGACTGTATG -> CGCCCTTGCGACTGTATGT
TCGCGACAAGCACTACGGA -> CGCGACAAGCACTACGGAG
TCGCGACGCAATTGGTAGA -> CGCGACGCAATTGGTAGAG
TCGCGCAGCCATCTATCTC -> CGCGCAGCCATCTATCTCA
TCGGAAAGTCATGTGCTGG -> CGGAAAGTCATGTGCTGGC
TCGGACTAGGCGAATTTTA -> CGGACTAGGCGAATTTTAG
TCGGCCAAATATTGAATGA -> CGGCCAAATATTGAATGAC
TCGGCCCAGGCCCAGAGGG -> CGGCCCAGGCCCAGAGGGG
TCGGCTCAGGTCCTTAAAC -> CGGCTCAGGTCCTTAAACG
TCGGCTGCTAGAGGACGCC -> CGGCTGCTAGAGGACGCCT
TCGGGACCCTAAATACGAC -> CGGGACCCTAAATACGACT
TCGGGAGATCTATGAATAA -> CGGGAGATCTATGAATAAC
TCGGGCGAACCCCTGCGTC -> CGGGCGAACCCCTGCGTCG
TCGGTATAGGTTAAGCCTC -> CGGTATAGGTTAAGCCTCG
TCGGTTTACTAGGCCTGGG -> CGGTTTACTAGGCCTGGGC
TCGGTTTTAGGCGAATTTT -> CGGTTTTAGGCGAATTTTA
TCGTAGGAATTCGCCCTTG -> CGTAGGAATTCGCCCTTGC
TCGTCAAGTCCGAAACCTT -> CGTCAAGTCCGAAACCTTC
TCGTGAATCGAACTATTAT -> CGTGAATCGAACTATTATG
TCGTGAGTATAAGCCGCAA -> CGTGAGTATAAGCCGCAAT
TCGTTGCAATTCGGCCAAA -> CGTTGCAATTCGGCCAAAT
TCGTTGTTTCCGCGCTAAT -> CGTTGTTTCCGCGCTAATC
TCTACAATGGTACGCAGCG -> CTACAATGGTACGCAGCGA
TCTACCGGGGAAAGTGGTA -> CTACCGGGGAAAGTGGTAA
TCTACGTACCCCTGTACCT -> CTACGTACCCCTGTACCTG
TCTACTACCTTACACCAAA -> CTACTACCTTACACCAAAA
TCTAGAGGAGGTCTACCGG -> CTAGAGGAGGTCTACCGGG
TCTAGATATGACATTAACG -> CTAGATATGACATTAACGT
TCTATAGGCGAAAATCGAC -> CTATAGGCGAAAATCGACA
TCTATCTCATCGATAAATA -> CTATCTCATCGATAAATAG
TCTATGAATAACATGGTTA -> CTATGAATAACATGGTTAT
TCTATGCGGGCGATGAGAT -> CTATGCGGGCGATGAGATT
TCTCAAAAATCGTAGGAAT -> CTCAAAAATCGTAGGAATT
TCTCAGCATGTGCATATAA -> CTCAGCATGTGCATATAAC
TCTCAGGTATGATTAATAT -> CTCAGGTATGATTAATATT
TCTCAGTTCGGAAAGTCAT -> CTCAGTTCGGAAAGTCATG
TCTCATCGATAAATAGGTG -> CTCATCGATAAATAGGTGA
TCTCCCTGCAGGACGTATT -> CTCCCTGCAGGACGTATTA
TCTCTAGAGGAGGTCTACC -> CTCTAGAGGAGGTCTACCG
TCTCTGACGAACTCTTTGG -> CTCTGACGAACTCTTTGGT
TCTGACGAACTCTTTGGTC -> CTGACGAACTCTTTGGTCC
TCTGACGACTAGCCTCAGA -> CTGACGACTAGCCTCAGAC
TCTGATCTTCGATCTCAAA -> CTGATCTTCGATCTCAAAA
TCTGCGAAGATTAGAGGGA -> CTGCGAAGATTAGAGGGAC
TCTGCGTACTTACATGGTC -> CTGCGTACTTACATGGTCC
TCTGCTTTACCTTTTATGT -> CTGCTTTACCTTTTATGTG
TCTGGAGTGGATCCTAAAG -> CTGGAGTGGATCCTAAAGG
TCTGGGGTTATACAGGTTC -> CTGGGGTTATACAGGTTCG
TCTGTACCCCAAAAGCCCG -> CTGTACCCCAAAAGCCCGA
TCTGTCTGTGACTACGCGC -> CTGTCTGTGACTACGCGCA
TCTGTGACTACGCGCAATG -> CTGTGACTACGCGCAATGT
TCTTCGATCTCAAAAATCG -> CTTCGATCTCAAAAATCGT
TCTTCGGTTTACTAGGCCT -> CTTCGGTTTACTAGGCCTG
TCTTTAGGTCCACCCGGGA -> CTTTAGGTCCACCCGGGAG
TCTTTGGTCCTTGAGGTCG -> CTTTGGTCCTTGAGGTCGC
TCTTTTACTGCCTCCCGCC -> CTTTTACTGCCTCCCGCCT
TCTTTTTGAAATCTGGGGT -> CTTTTTGAAATCTGGGGTT
TGAAACTGGATCGATGTCC -> GAAACTGGATCGATGTCCT
TGAAAGGGCCGTCCTCCTT -> GAAAGGGCCGTCCTCCTTA
TGAAATCTGGGGTTATACA -> GAAATCTGGGGTTATACAG
TGAACGTGCGGAGTTGGGG -> GAACGTGCGGAGTTGGGGC
TGAACTAACGACCAATTCG -> GAACTAACGACCAATTCGA
TGAATAACATGGTTATCTC -> GAATAACATGGTTATCTCT
TGAATCCGTTTTGCGTTCT -> GAATCCGTTTTGCGTTCTA
TGAATCGAACTATTATGTT -> GAATCGAACTATTATGTTG
TGAATGACGCAAGACGATG -> GAATGACGCAAGACGATGA
TGACAAATGTCTCAGCATG -> GACAAATGTCTCAGCATGT
TGACATTAACGTTTTATCG -> GACATTAACGTTTTATCGC
TGACGAACTCTTTGGTCCT -> GACGAACTCTTTGGTCCTT
TGACGACTAGCCTCAGACC -> GACGACTAGCCTCAGACCT
TGACGCAAGACGATGAGCC -> GACGCAAGACGATGAGCCG
TGACGGGGAGGTGTGGCAT -> GACGGGGAGGTGTGGCATA
TGACTACGCGCAATGTGCG -> GACTACGCGCAATGTGCGC
TGACTCGCGACAAGCACTA -> GACTCGCGACAAGCACTAC
TGACTTGGAACTGCTTGTC -> GACTTGGAACTGCTTGTCT
TGAGACTTACCCAATATTC -> GAGACTTACCCAATATTCT
TGAGATCTATAGGCGAAAA -> GAGATCTATAGGCGAAAAT
TGAGATTATACCGTGGGCG -> GAGATTATACCGTGGGCGG
TGAGCAATCTTTTACTGCC -> GAGCAATCTTTTACTGCCT
TGAGCAGATCAATAAGCGC -> GAGCAGATCAATAAGCGCA
TGAGCCGGCCCGCGGAAAT -> GAGCCGGCCCGCGGAAATC
TGAGCGATCGTCAAGTCCG -> GAGCGATCGTCAAGTCCGA
TGAGGTCGCATAACCCGAC -> GAGGTCGCATAACCCGACC
TGAGTATAAGCCGCAATAG -> GAGTATAAGCCGCAATAGG
TGAGTGTGTCGACTCAGAA -> GAGTGTGTCGACTCAGAAT
TGATAAGTTCAAGCGGGGT -> GATAAGTTCAAGCGGGGTG
TGATATAGTAGATTTGTCT -> GATATAGTAGATTTGTCTC
TGATCTCCCTGCAGGACGT -> GATCTCCCTGCAGGACGTA
TGATCTTCGATCTCAAAAA -> GATCTTCGATCTCAAAAAT
TGATGACTTGGAACTGCTT -> GATGACTTGGAACTGCTTG
TGATTAATATTGATCTCCC -> GATTAATATTGATCTCCCT
TGCAACCTTTTAGTTATGC -> GCAACCTTTTAGTTATGCC
TGCAATGTCGGCCCAGGCC -> GCAATGTCGGCCCAGGCCC
TGCAATTCGGCCAAATATT -> GCAATTCGGCCAAATATTG
TGCAGGACGTATTACGAGT -> GCAGGACGTATTACGAGTG
TGCATATAACCTCGCATCT -> GCATATAACCTCGCATCTA
TGCATGCGTGCAACCTTTT -> GCATGCGTGCAACCTTTTA
TGCCAACTTAGGCATATCT -> GCCAACTTAGGCATATCTG
TGCCGCAGAGAGGGTCAGA -> GCCGCAGAGAGGGTCAGAC
TGCCGGTAGTTTACATATC -> GCCGGTAGTTTACATATCA
TGCCTCCCGCCTCTGGAGT -> GCCTCCCGCCTCTGGAGTG
TGCGAACTGGTCGGGCGAA -> GCGAACTGGTCGGGCGAAC
TGCGAAGATTAGAGGGACG -> GCGAAGATTAGAGGGACGC
TGCGAAGGGTTGACGGGGA -> GCGAAGGGTTGACGGGGAG
TGCGACTGTATGTCGGCTC -> GCGACTGTATGTCGGCTCA
TGCGAGCAAATGTGCGCAA -> GCGAGCAAATGTGCGCAAT
TGCGCAATTAGTACAGCGA -> GCGCAATTAGTACAGCGAC
TGCGCCACAAGCCGTTCCT -> GCGCCACAAGCCGTTCCTC
TGCGCTCACATTCGTTGCA -> GCGCTCACATTCGTTGCAA
TGCGGAGTTGGGGCACAAT -> GCGGAGTTGGGGCACAATT
TGCGGCGAAGTAGACTAAA -> GCGGCGAAGTAGACTAAAC
TGCGGGCGATGAGATTATA -> GCGGGCGATGAGATTATAC
TGCGTACTTACATGGTCCG -> GCGTACTTACATGGTCCGA
TGCGTCGGTTTTAGGCGAA -> GCGTCGGTTTTAGGCGAAT
TGCGTGCAACCTTTTAGTT -> GCGTGCAACCTTTTAGTTA
TGCGTTCTATGCGGGCGAT -> GCGTTCTATGCGGGCGATG
TGCTAACGAGATCGCCAGA -> GCTAACGAGATCGCCAGAG
TGCTAGAGGACGCCTGTAC -> GCTAGAGGACGCCTGTACG
TGCTGGCTATCTGACGACT -> GCTGGCTATCTGACGACTA
TGCTGGTAGGCGAATTTTA -> GCTGGTAGGCGAATTTTAG
TGCTGTGCTGGTAGGCGAA -> GCTGTGCTGGTAGGCGAAT
TGCTTCCGACCAGCGACAA -> GCTTCCGACCAGCGACAAA
TGCTTGTCTACGTACCCCT -> GCTTGTCTACGTACCCCTG
TGCTTTACCTTTTATGTGC -> GCTTTACCTTTTATGTGCG
TGGAAATCGGTATAGGTTA -> GGAAATCGGTATAGGTTAA
TGGAACTGCTTGTCTACGT -> GGAACTGCTTGTCTACGTA
TGGACAAAACCAACCATCT -> GGACAAAACCAACCATCTT
TGGACGAACTATTATGTTG -> GGACGAACTATTATGTTGG
TGGAGTGGATCCTAAAGGT -> GGAGTGGATCCTAAAGGTG
TGGAGTGGTTCAACTCAGC -> GGAGTGGTTCAACTCAGCT
TGGAGTGTACGAGGTTGGC -> GGAGTGTACGAGGTTGGCT
TGGAGTGTGTGAGTGTGTC -> GGAGTGTGTGAGTGTGTCG
TGGAGTTATGAATCCGTTT -> GGAGTTATGAATCCGTTTT
TGGATCACTTGACAAATGT -> GGATCACTTGACAAATGTC
TGGATCCTAAAGGTGGGTA -> GGATCCTAAAGGTGGGTAG
TGGATCGATGTCCTTGGTT -> GGATCGATGTCCTTGGTTA
TGGCATAGGCGAATTTTAG -> GGCATAGGCGAATTTTAGG
TGGCCTTGCCAACTTAGGC -> GGCCTTGCCAACTTAGGCA
TGGCTATCTGACGACTAGC -> GGCTATCTGACGACTAGCC
TGGCTATCTGTCTGTGACT -> GGCTATCTGTCTGTGACTA
TGGCTCGAGCGATCGTTGT -> GGCTCGAGCGATCGTTGTT
TGGCTTGTCATTTCTACAA -> GGCTTGTCATTTCTACAAT
TGGGAAAATGCGGCGAAGT -> GGGAAAATGCGGCGAAGTA
TGGGAGACATTATCTTTTT -> GGGAGACATTATCTTTTTG
TGGGCAGCACAAATTACCT -> GGGCAGCACAAATTACCTA
TGGGCGGGGACCAGGTGAG -> GGGCGGGGACCAGGTGAGC
TGGGCTCGCAAGTGTCCGG -> GGGCTCGCAAGTGTCCGGA
TGGGGCACAATTATGGCTT -> GGGGCACAATTATGGCTTG
TGGGGTTATACAGGTTCGA -> GGGGTTATACAGGTTCGAG
TGGGTAGAAACCAGTCCAC -> GGGTAGAAACCAGTCCACT
TGGTAAATTCAGCTGTGGT -> GGTAAATTCAGCTGTGGTG
TGGTAACTTGGATCACTTG -> GGTAACTTGGATCACTTGA
TGGTACGCAGCGAAGCCGC -> GGTACGCAGCGAAGCCGCG
TGGTAGAGTAATGCTGTGC -> GGTAGAGTAATGCTGTGCT
TGGTAGGCGAATTTTAGGA -> GGTAGGCGAATTTTAGGAA
TGGTCCGAGCTGGGAAAAT -> GGTCCGAGCTGGGAAAATG
TGGTCCTTGAGGTCGCATA -> GGTCCTTGAGGTCGCATAA
TGGTCGGGCGAACCCCTGC -> GGTCGGGCGAACCCCTGCG
TGGTCGTGAGTATAAGCCG -> GGTCGTGAGTATAAGCCGC
TGGTGCGAACTGGTCGGGC -> GGTGCGAACTGGTCGGGCG
TGGTGTGTGAAAGGGCCGT -> GGTGTGTGAAAGGGCCGTC
TGGTTAGAGCCCTCGGGAC -> GGTTAGAGCCCTCGGGACC
TGGTTATCTCTGACGAACT -> GGTTATCTCTGACGAACTC
TGGTTCAACTCAGCTTTAC -> GGTTCAACTCAGCTTTACC
TGTACCCCAAAAGCCCGAA -> GTACCCCAAAAGCCCGAAG
TGTACCTGACTCGCGACAA -> GTACCTGACTCGCGACAAG
TGTACGAGGTTGGCTATCT -> GTACGAGGTTGGCTATCTG
TGTACGCCTACTTCCAGCG -> GTACGCCTACTTCCAGCGT
TGTATGTCGGCTCAGGTCC -> GTATGTCGGCTCAGGTCCT
TGTCACACTCGCATGATAA -> GTCACACTCGCATGATAAG
TGTCATTTCTACAATGGTA -> GTCATTTCTACAATGGTAC
TGTCCGGAGACGTAGAGTC -> GTCCGGAGACGTAGAGTCC
TGTCCTTGGTTAGAGCCCT -> GTCCTTGGTTAGAGCCCTC
TGTCGACTCAGAATGTGAA -> GTCGACTCAGAATGTGAAC
TGTCGATCCGGAAAATCAG -> GTCGATCCGGAAAATCAGC
TGTCGGCCCAGGCCCAGAG -> GTCGGCCCAGGCCCAGAGG
TGTCGGCTCAGGTCCTTAA -> GTCGGCTCAGGTCCTTAAA
TGTCTACGTACCCCTGTAC -> GTCTACGTACCCCTGTACC
TGTCTCAGCATGTGCATAT -> GTCTCAGCATGTGCATATA
TGTCTCAGTTCGGAAAGTC -> GTCTCAGTTCGGAAAGTCA
TGTCTGTGACTACGCGCAA -> GTCTGTGACTACGCGCAAT
TGTGAAAGGGCCGTCCTCC -> GTGAAAGGGCCGTCCTCCT
TGTGAACTAACGACCAATT -> GTGAACTAACGACCAATTC
TGTGACTACGCGCAATGTG -> GTGACTACGCGCAATGTGC
TGTGAGTGTGTCGACTCAG -> GTGAGTGTGTCGACTCAGA
TGTGCATATAACCTCGCAT -> GTGCATATAACCTCGCATC
TGTGCGCAATTAGTACAGC -> GTGCGCAATTAGTACAGCG
TGTGCGCCACAAGCCGTTC -> GTGCGCCACAAGCCGTTCC
TGTGCGCTCACATTCGTTG -> GTGCGCTCACATTCGTTGC
TGTGCTGGCTATCTGACGA -> GTGCTGGCTATCTGACGAC
TGTGCTGGTAGGCGAATTT -> GTGCTGGTAGGCGAATTTT
TGTGGCATAGGCGAATTTT -> GTGGCATAGGCGAATTTTA
TGTGGTGCGAACTGGTCGG -> GTGGTGCGAACTGGTCGGG
TGTGTCGACTCAGAATGTG -> GTGTCGACTCAGAATGTGA
TGTGTGAAAGGGCCGTCCT -> GTGTGAAAGGGCCGTCCTC
TGTGTGAGTGTGTCGACTC -> GTGTGAGTGTGTCGACTCA
TGTTGGAGTGGTTCAACTC -> GTTGGAGTGGTTCAACTCA
TGTTGGAGTGTACGAGGTT -> GTTGGAGTGTACGAGGTTG
TGTTGGAGTGTGTGAGTGT -> GTTGGAGTGTGTGAGTGTG
TGTTGGAGTTATGAATCCG -> GTTGGAGTTATGAATCCGT
TGTTGGCTCGAGCGATCGT -> GTTGGCTCGAGCGATCGTT
TGTTTCCGCGCTAATCACC -> GTTTCCGCGCTAATCACCA
TTAAACGGTCCTAACCACA -> TAAACGGTCCTAACCACAG
TTAACGTTTTATCGCGACG -> TAACGTTTTATCGCGACGC
TTAAGCCTCGCGCAGCCAT -> TAAGCCTCGCGCAGCCATC
TTAATATTGATCTCCCTGC -> TAATATTGATCTCCCTGCA
TTACACCAAAATGCTAACG -> TACACCAAAATGCTAACGA
TTACATATCAGGTTAGCAC -> TACATATCAGGTTAGCACC
TTACATGGTCCGAGCTGGG -> TACATGGTCCGAGCTGGGA
TTACCACACAGGAAGCCAT -> TACCACACAGGAAGCCATC
TTACCCAATATTCTTCGGT -> TACCCAATATTCTTCGGTT
TTACCCTATAACGAACTAT -> TACCCTATAACGAACTATT
TTACCTATAATTTGGCCTT -> TACCTATAATTTGGCCTTG
TTACCTCTCAGGTATGATT -> TACCTCTCAGGTATGATTA
TTACCTTTTATGTGCGCTC -> TACCTTTTATGTGCGCTCA
TTACGAGTGCATGCGTGCA -> TACGAGTGCATGCGTGCAA
TTACTAGGCCTGGGCTCGC -> TACTAGGCCTGGGCTCGCA
TTACTGCCTCCCGCCTCTG -> TACTGCCTCCCGCCTCTGG
TTAGAGCCCTCGGGACCCT -> TAGAGCCCTCGGGACCCTA
TTAGAGGACAACCTTGATA -> TAGAGGACAACCTTGATAT
TTAGAGGGACGCTATACCA -> TAGAGGGACGCTATACCAG
TTAGCACCCTCAGGTGAGA -> TAGCACCCTCAGGTGAGAT
TTAGGAAGACTTCGTGAAT -> TAGGAAGACTTCGTGAATC
TTAGGAAGCGTCAGACCTT -> TAGGAAGCGTCAGACCTTC
TTAGGAAGGTAAGATTGGA -> TAGGAAGGTAAGATTGGAC
TTAGGAAGTTACCCTATAA -> TAGGAAGTTACCCTATAAC
TTAGGCATATCTGCGTACT -> TAGGCATATCTGCGTACTT
TTAGGCGAATTTTAGGAAG -> TAGGCGAATTTTAGGAAGT
TTAGGTCCACCCGGGAGGC -> TAGGTCCACCCGGGAGGCC
TTAGTACAGCGACTAATTT -> TAGTACAGCGACTAATTTC
TTAGTTATGCCGCAGAGAG -> TAGTTATGCCGCAGAGAGG
TTATACAGGTTCGAGCATA -> TATACAGGTTCGAGCATAT
TTATACCGTGGGCGGGGAC -> TATACCGTGGGCGGGGACC
TTATAGTGGTCGTGAGTAT -> TATAGTGGTCGTGAGTATA
TTATCGCGACGCAATTGGT -> TATCGCGACGCAATTGGTA
TTATCTCTGACGAACTCTT -> TATCTCTGACGAACTCTTT
TTATCTTTTTGAAATCTGG -> TATCTTTTTGAAATCTGGG
TTATGAATCCGTTTTGCGT -> TATGAATCCGTTTTGCGTT
TTATGCCGCAGAGAGGGTC -> TATGCCGCAGAGAGGGTCA
TTATGGCTTGTCATTTCTA -> TATGGCTTGTCATTTCTAC
TTATGTGCGCTCACATTCG -> TATGTGCGCTCACATTCGT
TTATGTTGGAGTGGTTCAA -> TATGTTGGAGTGGTTCAAC
TTATGTTGGAGTGTACGAG -> TATGTTGGAGTGTACGAGG
TTATGTTGGAGTGTGTGAG -> TATGTTGGAGTGTGTGAGT
TTATGTTGGAGTTATGAAT -> TATGTTGGAGTTATGAATC
TTCAACTCAGCTTTACCAC -> TCAACTCAGCTTTACCACA
TTCAAGCGGGGTGAGCGAT -> TCAAGCGGGGTGAGCGATC
TTCAGCTGTGGTGCGAACT -> TCAGCTGTGGTGCGAACTG
TTCAGTCCCCGAACCTCTG -> TCAGTCCCCGAACCTCTGA
TTCCACCCACGTGATGACT -> TCCACCCACGTGATGACTT
TTCCAGCGTGAACGTGCGG -> TCCAGCGTGAACGTGCGGA
TTCCCGGAACTGGAAATCG -> TCCCGGAACTGGAAATCGG
TTCCGACCAGCGACAAAGG -> TCCGACCAGCGACAAAGGA
TTCCGCGCTAATCACCAAA -> TCCGCGCTAATCACCAAAA
TTCCTCGGACTAGGCGAAT -> TCCTCGGACTAGGCGAATT
TTCGAACTATTATGTTGGA -> TCGAACTATTATGTTGGAG
TTCGAATCTGCTTTACCTT -> TCGAATCTGCTTTACCTTT
TTCGAGCATATATGAATTC -> TCGAGCATATATGAATTCG
TTCGATCTCAAAAATCGTA -> TCGATCTCAAAAATCGTAG
TTCGCCCTTGCGACTGTAT -> TCGCCCTTGCGACTGTATG
TTCGGAAAGTCATGTGCTG -> TCGGAAAGTCATGTGCTGG
TTCGGCCAAATATTGAATG -> TCGGCCAAATATTGAATGA
TTCGGTTTACTAGGCCTGG -> TCGGTTTACTAGGCCTGGG
TTCGTGAATCGAACTATTA -> TCGTGAATCGAACTATTAT
TTCGTTGCAATTCGGCCAA -> TCGTTGCAATTCGGCCAAA
TTCTACAATGGTACGCAGC -> TCTACAATGGTACGCAGCG
TTCTACTACCTTACACCAA -> TCTACTACCTTACACCAAA
TTCTATGCGGGCGATGAGA -> TCTATGCGGGCGATGAGAT
TTCTTCGGTTTACTAGGCC -> TCTTCGGTTTACTAGGCCT
TTGAAATCTGGGGTTATAC -> TGAAATCTGGGGTTATACA
TTGAATGACGCAAGACGAT -> TGAATGACGCAAGACGATG
TTGACAAATGTCTCAGCAT -> TGACAAATGTCTCAGCATG
TTGACGGGGAGGTGTGGCA -> TGACGGGGAGGTGTGGCAT
TTGAGGTCGCATAACCCGA -> TGAGGTCGCATAACCCGAC
TTGATATAGTAGATTTGTC -> TGATATAGTAGATTTGTCT
TTGATCTCCCTGCAGGACG -> TGATCTCCCTGCAGGACGT
TTGCAATTCGGCCAAATAT -> TGCAATTCGGCCAAATATT
TTGCCAACTTAGGCATATC -> TGCCAACTTAGGCATATCT
TTGCCGGTAGTTTACATAT -> TGCCGGTAGTTTACATATC
TTGCGACTGTATGTCGGCT -> TGCGACTGTATGTCGGCTC
TTGCGTTCTATGCGGGCGA -> TGCGTTCTATGCGGGCGAT
TTGGAACTGCTTGTCTACG -> TGGAACTGCTTGTCTACGT
TTGGACGAACTATTATGTT -> TGGACGAACTATTATGTTG
TTGGAGTGGTTCAACTCAG -> TGGAGTGGTTCAACTCAGC
TTGGAGTGTACGAGGTTGG -> TGGAGTGTACGAGGTTGGC
TTGGAGTGTGTGAGTGTGT -> TGGAGTGTGTGAGTGTGTC
TTGGAGTTATGAATCCGTT -> TGGAGTTATGAATCCGTTT
TTGGATCACTTGACAAATG -> TGGATCACTTGACAAATGT
TTGGCCTTGCCAACTTAGG -> TGGCCTTGCCAACTTAGGC
TTGGCTATCTGTCTGTGAC -> TGGCTATCTGTCTGTGACT
TTGGCTCGAGCGATCGTTG -> TGGCTCGAGCGATCGTTGT
TTGGGGCACAATTATGGCT -> TGGGGCACAATTATGGCTT
TTGGTAGAGTAATGCTGTG -> TGGTAGAGTAATGCTGTGC
TTGGTCCTTGAGGTCGCAT -> TGGTCCTTGAGGTCGCATA
TTGGTTAGAGCCCTCGGGA -> TGGTTAGAGCCCTCGGGAC
TTGTCACACTCGCATGATA -> TGTCACACTCGCATGATAA
TTGTCATTTCTACAATGGT -> TGTCATTTCTACAATGGTA
TTGTCTACGTACCCCTGTA -> TGTCTACGTACCCCTGTAC
TTGTCTCAGTTCGGAAAGT -> TGTCTCAGTTCGGAAAGTC
TTGTTGGCTCGAGCGATCG -> TGTTGGCTCGAGCGATCGT
TTGTTTCCGCGCTAATCAC -> TGTTTCCGCGCTAATCACC
TTTACATATCAGGTTAGCA -> TTACATATCAGGTTAGCAC
TTTACCACACAGGAAGCCA -> TTACCACACAGGAAGCCAT
TTTACCTTTTATGTGCGCT -> TTACCTTTTATGTGCGCTC
TTTACTAGGCCTGGGCTCG -> TTACTAGGCCTGGGCTCGC
TTTACTGCCTCCCGCCTCT -> TTACTGCCTCCCGCCTCTG
TTTAGAGGACAACCTTGAT -> TTAGAGGACAACCTTGATA
TTTAGGAAGACTTCGTGAA -> TTAGGAAGACTTCGTGAAT
TTTAGGAAGCGTCAGACCT -> TTAGGAAGCGTCAGACCTT
TTTAGGAAGGTAAGATTGG -> TTAGGAAGGTAAGATTGGA
TTTAGGAAGTTACCCTATA -> TTAGGAAGTTACCCTATAA
TTTAGGCGAATTTTAGGAA -> TTAGGCGAATTTTAGGAAG
TTTAGGTCCACCCGGGAGG -> TTAGGTCCACCCGGGAGGC
TTTAGTTATGCCGCAGAGA -> TTAGTTATGCCGCAGAGAG
TTTATAGTGGTCGTGAGTA -> TTATAGTGGTCGTGAGTAT
TTTATCGCGACGCAATTGG -> TTATCGCGACGCAATTGGT
TTTATGTGCGCTCACATTC -> TTATGTGCGCTCACATTCG
TTTCCCGGAACTGGAAATC -> TTCCCGGAACTGGAAATCG
TTTCCGCGCTAATCACCAA -> TTCCGCGCTAATCACCAAA
TTTCTACAATGGTACGCAG -> TTCTACAATGGTACGCAGC
TTTGAAATCTGGGGTTATA -> TTGAAATCTGGGGTTATAC
TTTGCGTTCTATGCGGGCG -> TTGCGTTCTATGCGGGCGA
TTTGGCCTTGCCAACTTAG -> TTGGCCTTGCCAACTTAGG
TTTGGTCCTTGAGGTCGCA -> TTGGTCCTTGAGGTCGCAT
TTTGTCTCAGTTCGGAAAG -> TTGTCTCAGTTCGGAAAGT
TTTTACTGCCTCCCGCCTC -> TTTACTGCCTCCCGCCTCT
TTTTAGGAAGACTTCGTGA -> TTTAGGAAGACTTCGTGAA
TTTTAGGAAGCGTCAGACC -> TTTAGGAAGCGTCAGACCT
TTTTAGGAAGGTAAGATTG -> TTTAGGAAGGTAAGATTGG
TTTTAGGAAGTTACCCTAT -> TTTAGGAAGTTACCCTATA
TTTTAGGCGAATTTTAGGA -> TTTAGGCGAATTTTAGGAA
TTTTAGTTATGCCGCAGAG -> TTTAGTTATGCCGCAGAGA
TTTTATCGCGACGCAATTG -> TTTATCGCGACGCAATTGG
TTTTATGTGCGCTCACATT -> TTTATGTGCGCTCACATTC
TTTTGAAATCTGGGGTTAT -> TTTGAAATCTGGGGTTATA
TTTTGCGTTCTATGCGGGC -> TTTGCGTTCTATGCGGGCG
TTTTTGAAATCTGGGGTTA -> TTTTGAAATCTGGGGTTAT
